projet - lord of read
An Interactive Fiction by Simon
Release 1 / Serial number 210517 / Inform 7 build 6M62 (I6/v6.34 lib 6/12N) SD

Old room
Something here calls to you, like a whisper in the wind or the faint rustling of the worn pages of a well-loved book. Around and above you the walls are covered in paint. Scattered scenes chase each other without order or thought, a majestic blue dragon flies over mountain peaks, a great lion roars at the foot of a white castle and on the ceiling someone too small to be a man smiles forlornly, behind him ships ready to sail in the unknown.

You can see an old table (on which is a mysterious book) here.

>ask Gandalf
You could ask about Who are you, What are you, or WTF.
This person has nothing to say.

>ask Gandlaf about
You can't see any such thing.

>ask Gandalf about
You could ask about Who are you, What are you, or WTF.
This person has nothing to say.

>ask Gandalf wtf
I only understood you as far as wanting to ask Gandalf.

>ask Gandalf
You could ask about Who are you, What are you, or WTF.
This person has nothing to say.

* * *

>ask Gandalf about who are you
My name is Gandalf, I'm a magicien.

>ask Gandalf wo are you
I only understood you as far as wanting to ask Gandalf.

>showme me
yourself - person
location: in the shire
singular-named, proper-named; unlit, inedible, portable; male, visible
list grouping key: none
printed name: "yourself"
printed plural name: "people"
indefinite article: none
description: "As good-looking as ever."
initial appearance: none
carrying capacity: 100
Responses Table: (the empty table)

>ask sam
You could ask about Who are you, What are you, or WTF.

>ask table
You can't see any such thing.

>ask sam
You could ask about Who are you, What are you, or WTF.

>ask gandalf
You could ask about Who are you, What are you, or WTF.
This person has nothing to say.

* * *

>ask sam
You could ask about Who are you, What are you, or WTF.

>ask sam about
You could ask about Who are you, What are you, or WTF.

>ask sam & pip
You could ask about Who are you, What are you, or WTF.

>ask gandalf
You could ask about Who are you, What are you, or WTF.
This person has nothing to say.

>ask sam about who are you
My name is Gandalf, I'm a magicien.

>ask gandalf about who are you
My name is Gandalf, I'm a magicien.

>teleport to mount doom
That's not a verb I recognize.

>go to room
old room
DESCRIPTION

You can see an old table (on which is an old book) here.

>go to old room
old room
DESCRIPTION

You can see an old table (on which is an old book) here.

>go to rivendell
Rivendell
DESCRIPTION

You can see an Elf Lord and a pedestal (on which are an old sword and a shirt in chainmail) here.

>ask elf
This person has nothing to say.

* * *

>ask sam
You can't see any such thing.

>go to the shire
shire
DESCRIPTION

You can see Gandalf and Sam & Pip here.

>ask sam
You could ask about Who are you, What are you, or WTF.

>showme me
yourself - person
location: in the shire
singular-named, proper-named; unlit, inedible, portable; male, visible
list grouping key: none
printed name: "yourself"
printed plural name: "people"
indefinite article: none
description: "As good-looking as ever."
initial appearance: none
carrying capacity: 100
Responses Table: (the empty table)

>show me Gandalf
(first taking Gandalf)
I don't suppose Gandalf would care for that.

>showme Gandalf
Gandalf - caracter
location: in the shire
singular-named, proper-named; unlit, inedible, portable; male, visible
list grouping key: none
printed name: "Gandalf"
printed plural name: "caracters"
indefinite article: none
description: none
initial appearance: none
carrying capacity: 100
Responses Table: Table of Gandalf Responses

* * *

>ask Gandalf about
You could ask about him, What are you, or WTF.

>ask gandlaf about wtf
You can't see any such thing.

>ask gandalf about wtf
You really want to take the Eagle to go directly to mount doom ?

>no
As you please.

>ask gandalf about wtf
You really want to take the Eagle to go directly to mount doom ?

>yes
You are transporting to mount doom be the eagle. You find a easy shortcut ! But wait... it seem that you are to weak for this kind of transport... we need to stop befor you trow up, sorry.
Rivendell
DESCRIPTION

You can see an Elf Lord and a pedestal (on which are an old sword and a shirt in chainmail) here.

* * *

>ask gandalf
You could ask about him, something, or WTF.

>ask gandalf about him
My name is Gandalf, I'm a magicien.

>ask gandalf about wtf
You really want to take the Eagle to go directly to mount doom ?

>yes
You are transporting to mount doom be the eagle. You find a easy shortcut ! But wait... it seem that you are to weak for this kind of transport... we need to stop befor you trow up, sorry.
Rivendell
At the edge of a narrow gorge, the peaceful elven town of Rivendell seems almost to sit on the river Bruinen. Wherever you are you can hear water streaming by or roaring down steep cliffs. Maybe before exploring you should look for someone to talk to.

You can see an Elf Lord and a pedestal (on which are an old sword and a mithril shirt) here.

* * *

>ask gandalf
You could ask about him, something, or WTF.

>ask gandalf about who are you
My name is Gandalf, I'm a magicien.

>ask sam about who are you
My name is Sam, I'm a perfect teammate.Glulxe fatal error: Memory access out of range (19A0259)

>ask sam
You could ask about Who are you, What are you, or WTF.

>ask gandalf
You could ask about him, What are you, or WTF.

>showme me
yourself - person
location: in the shire
singular-named, proper-named; unlit, inedible, portable; male, visible
list grouping key: none
printed name: "yourself"
printed plural name: "people"
indefinite article: none
description: "As good-looking as ever."
initial appearance: none
carrying capacity: 100
Responses Table: (the empty table)

>talk to gandalf
To start a conversation, you need to use ASK Gandalf ABOUT something. Type "ask Gandalf (about)" to see the available's topic.

>ask gandalf about
You could ask about him, What are you, or WTF.

>ask gandalf
You could ask about him, What are you, or WTF.

>tell gandalf about who are you
My name is Gandalf, I'm a magicien.

>ask gandalf about him
My name is Gandalf, I'm a magicien.

* * *

>ask gandalf about who are you
My name is Gandalf, I'm a magicien.

* * *

>ask gandalf about his name
My name is Gandalf, I'm a magicien.

>ask same about his name
You can't see any such thing.

>ask sam about his name
My name is Sam, I'm a perfect teammate.

>ask sam about him
My name is Sam, I'm a perfect teammate.

* * *

>ask gandalf about did you anderstand me
Of course I do, I everything fine?I can do an action here

>go to house
Bilbo's House
DESCRIPTION

You can see a little table (on which are a little book and a map), a trunk (in which are a pipe and a bag of money), and a cupboard here.

>talk to table
You can only do that to something animate.

>go to shire
shire
DESCRIPTION

You can see Gandalf and Sam & Pip here.

* * *

>ask gandalf
You could ask about him, something, or WTF.

>wtf
You can't see any such thing.

>WTF
That's not a verb I recognize.

>ask gandalf WTF
I didn't understand that sentence.

* * *

>ask gandalf about who are you
My name is Gandalf, I'm a magicien

>ask gandalf if he anderstand me
I didn't understand that sentence.

>ask gandalf who he is
I didn't understand that sentence.

* * *

>ask gandalf about him
My name is Gandalf, I'm a magicien.

>ask gandalf about him
Yeah yeah, i'm busy little boy, stop asking me the same question again and again please.

>ask gandalf about him
Are you Ok frodon, you seem to be more stupid as always...

>ask gandalf about him
Are you Ok frodon, you seem to be more stupid as always...

>ask gandalf about him
The answer is in the BOOK ! You fool...

>ask gandalf about him
I already talk to you abou that.

>ask gandalf about him
Yeah yeah, i'm busy little boy, stop asking me the same question again and again please.

* * *

>ask gandalf about him
Are you Ok frodon, you seem to be more stupid as always...

>ask gandalf about him
Yeah yeah, i'm busy little boy, stop asking me the same question again and again please.

>ask gandalf about him
I already talk to you abou that.

I beg your pardon?

* * *

>ask gandalf about him
Are you Ok frodon, you seem to be more stupid as always...

>showme gandalf
Gandalf - caracter
location: in the shire
singular-named, proper-named; unlit, inedible, portable; male, visible
list grouping key: none
printed name: "Gandalf"
printed plural name: "caracters"
indefinite article: none
description: none
initial appearance: none
carrying capacity: 100
Responses Table: Table of Gandalf Responses
Answered List:

>ask gandalf about wtf
You really want to take the Eagle to go directly to mount doom ?

>n
As you please.

>ask gandalf about wtf
You really want to take the Eagle to go directly to mount doom ?

* * *

>n
As you please.

>n
You can't go that way.

>ask gandalf about wtf
You really want to take the Eagle to go directly to mount doom ?

>y
You are transporting to mount doom be the eagle. You find a easy shortcut ! But wait... it seem that you are to weak for this kind of transport... we need to stop befor you trow up, sorry.
Rivendell
DESCRIPTION

You can see an Elf Lord and a pedestal (on which are an old sword and a shirt in chainmail) here.

>ask elf
This person has nothing to say.

>e
You can't go that way.

>w
shire
DESCRIPTION

You can see Gandalf and Sam & Pip here.

>ask sam about him
Glulxe fatal error: Memory access out of range (58231E03)

>ask sam
You could ask about Who are you, What are you, or WTF.

* * *

>ask gandalf about him
My name is Gandalf, I'm a magicien.

>ask gandalf about something
I'm a magicien, and my name is Gandalf

>ask gandalf about something
I already talk to you about that.

>ask gandalf about him
I already talk to you about that.

>ask sam about him
My name is Sam, I'm a perfect teammate.

* * *

>ask sam about test
Of course I do, I everything fine?

>ask sam about test
I already talk to you about that.

>ask sam about something
I'm a magicien, and my name is Gandalf

>ask sam about him
I already talk to you about that.

>ask gandalf about something
I already talk to you about that.

>ask gandalf
You could ask about him, something, or WTF.

* * *

>ask gandalf about him
My name is Gandalf, I'm a magicien.

>ask sam about him
My name is Sam, I'm a perfect teammate.

>ask sam about what are you
I already talk to you about that.

>showme sam
Sam & Pip - caracter
location: in the shire
singular-named, proper-named; unlit, inedible, portable; male, visible
list grouping key: none
printed name: "Sam & Pip"
printed plural name: "caracters"
indefinite article: none
description: none
initial appearance: none
carrying capacity: 100
Responses Table: Table of Sam Responses
Answered List: him

>ask gandlaf about wtf
You can't see any such thing.

* * *

>ask gandalf about him
My name is Gandalf, I'm a magicien.

>ask sam about what are you
My name is Sam, I'm a perfect teammate.

>ask sam about him
I already take to you about that.

* * *

>ask gandalf about who are you
My name is Gandalf, I'm a magicien.

>push
Strong man

* * *

>e
Rivendell
DESCRIPTION

You can see an Elf Lord and a pedestal (on which are an old sword and a shirt in chainmail) here.

>w
shire
DESCRIPTION

You can see Gandalf and Sam & Pip here.

>w
Bilbo's House
DESCRIPTION

>e
shire
DESCRIPTION

You can see Gandalf and Sam & Pip here.

>teleport to rivendell
You can't see any such thing.

* * *

>enter the House
You can't see any such thing.

>showme house
Bilbo's House - room
    little table - supporter
        little book
        map
    trunk - open container
        pipe
        bag of money
    cupboard
singular-named, improper-named; lighted, unvisited
list grouping key: none
printed name: "Bilbo's House"
printed plural name: none
indefinite article: none
description: "DESCRIPTION"
map region: story

>tke house
That's not a verb I recognize.

>take hous
You can't see any such thing.

>take house
You can't see any such thing.

>go to house
You can't see any such thing.

>e
Rivendell
DESCRIPTION

You can see an Elf Lord and a pedestal (on which are an old sword and a shirt in chainmail) here.

* * *

>w
shire
DESCRIPTION

You can see Gandalf and Sam & Pip here.

>w
You can't go that way.

* * *

>s
You can't go that way.

>d
You can't go that way.

* * *

>u
You can't go that way.

>n
You can't go that way.

>go inside
You can't go that way.

>go outside
Bilbo's House
DESCRIPTION

You can see a little table (on which are a little book and a map), a trunk (in which are a pipe and a bag of money), and a cupboard here.

* * *

>enter the house
You can't see any such thing.

* * *

>go
You'll have to say which compass direction to go in.

>d
You can't go that way.

>go to the House
You can't see any such thing.

>teleport to house
You can't see any such thing.

>showme bilbo's house
Bilbo's House - room
    little table - supporter
        little book
        map
    trunk - open container
        pipe
        bag of money
    cupboard
singular-named, improper-named; lighted, unvisited
list grouping key: none
printed name: "Bilbo's House"
printed plural name: none
indefinite article: none
description: "DESCRIPTION"

>enter the house
You can't see any such thing.

* * *

>go inside
Bilbo's House
DESCRIPTION

You can see a little table (on which are a little book and a map), a trunk (in which are a pipe and a bag of money), and a cupboard here.

>go outside
shire
DESCRIPTION

You can see Gandalf and Sam & Pip here.

>teleport to house
You can't see any such thing.

* * *

>go shire
You can't see any such thing.

>go to the shire
Shire
Round, colorful doors are set in the sprawling green hills, from the tops of which the smoke of small chimneys hints at homely meals shared at round tables. Some hobbits are venturing the paths between smials, others are enjoying the sun. Gandalf towers above all even while sitting on his favorite chair. You can see Sam & Pip lounging on the grass.

>ask gandalf about
You could ask about me, the weather, or the quest.

>ask gandalf about the weather
A lovely summery day, Frodo. The shadows of war are far but getting closer, soon even the Shire will know the end of its peace.

>ask gandalf about
You could ask about me or the quest.

>ask gandalf about me
Did you smoke something? Are you alright? Is this some sort of test? You are Frodo Baggins, of course, hobbit of the Shire.
subtopics??????

>ask gandalf about him
I am Gandalf the Grey. I was sent to Middle Earth to help destroy the ring that you now hold. I am an Istar , a wizard of old.

>ask gandalf
You could ask about the quest or life.

>ask gandalf about life
You shall not distract yourself with nonsensical and philosophical questions. If you are here to waste my time, go read a book.
subtopics??????

>ask gandalf
You could ask about the quest, books, pipe-weed, or the ring.

>ask gandalf about pipe
I d'ont see what you mean, sorry.

>ask gandalf about pipe-weed
Mmh… some of the finest weed is actually grown here in the Shire. If you manage to find some, be sure to share it with you dear friend Gandalf.

>ask gandalf about the ring
The object that you now have in your possession has many names Frodo: the One Ring, Isidur's Bane, the Ring of Power. It is a very dark and very powerful artifact, one that can only be destroyed where it was created: in the fire of Mount Doom.

>ask gandalf about
You could ask about the quest or books.

>ask gandalf about books
Ah, the keepers of knowledge. I don't have any here with me at the moment, but I would bet my beard that Bilbo left you some interesting reads at Bag End.

>ask gandalf about books
Yeah yeah, I'm busy little boy, stop asking me the same questions again and again.

>ask gandalf about
You could ask about the quest.

>ask gandalf about the quest
A great adventure that will take you to places unknown. A long time ago the ring you now hold was created by Sauron, a great evil, to rule over Middle Earth. After a bloody war the ring was cut from its master's hand and lost to the ages. Somehow your uncle Bilbo found it and passed it on to you Frodo. You are the one, the chosen, he who must go to Mount Doom and destroy the ring once and for all. Before the world is plunged in darkness.
subtopics??????

>ask gandalf
You could ask about Mount Doom.

>ask gandalf about mount doom
The great volcano lies south of here, beyond the mountains. It is the only place where the ring may be vanquished, the final destination to your adventure. I could accompany you there… may I suggest we use the Eagles? They are great beasts and should take us to Mount Doom in no time at all. Would you like to leave right now?

>y
An easy shortcut! How lucky you are!
 You mount on a beautiful Eagle and soon you find yourself flying above the green Shire. Is that really Sam down there, he looks so little, so small, maybe a little too miniscule. Are we sure we are safe flying so high? DON'T LOOK DOWN, DON'T…

It looks like you are too weak for this mode of transportation, we should stop before you throw up on yourself and the Eagle (she might eat you, they really like to keep themselves clean).
You are now in Rivendell...

Rivendell
At the edge of a narrow gorge, the peaceful elven town of Rivendell seems almost to sit on the river Bruinen. Wherever you are you can hear water streaming by or roaring down steep cliffs. Maybe before exploring you should look for someone to talk to.

You can see Gandalf, an Elf Lord, and a pedestal (on which are an old sword and a mithril shirt) here.

>ask gandalf about
You could ask about the Elf Council, me, Mount Doom, Rivendell
, Mildred, or the quest.

>ask gandalf about the quest
The Elf Council is still in session. I think you should wait and hear what they have to say.

>ask gandalf about the quest
Yeah yeah, I'm busy little boy, stop asking me the same questions again and again.

>ask gandalf about the quest
Are you ok Frodo? You seem to be more stupid than usual...

>ask gandalf about the quest
Yeah yeah, I'm busy little boy, stop asking me the same questions again and again.

* * *

>ask gandalf about the quest
Are you ok Frodo? You seem to be more stupid than usual...

>ask gandalf about the quest
I already talked to you about that.

>ask gandalf about the quest
Yeah yeah, I'm busy little boy, stop asking me the same questions again and again.

>ask gandalf about
You could ask about the Elf Council, me, Mount Doom, Rivendell
, or Mildred.

* * *

>go to bag end
Bag End
You find yourself in a cavernicolous and airy room. Doors, windows and ceilings are round, like if someone has carved holes in the earth itself. Outside you can hear the laughter of children and the chirping of birds.

You can see a little table (on which are a green book and a map), a trunk (closed), and a cupboard here.

>read book
You open the green book at a random page.

This is the story of the fellow from out of time and space 

There was, once upon a time,
a young lost fellow without dime.
Taken by a book, he said
but the hobbits just thought him mad.
He looked around, and he went east,
then west, then back, then flew on a great beast.
For the life of him he could not remember,
how he came to be or if it was July or December.
He spoke with many, fought with few, 
but in the end, he decided to just enjoy the view.
 He rolled his weed, sat on a chair,
took out his pipe and smoked without flair.

Here ends the story of the young fellow,
he sure must have been relaxed and mellow,
because soon he disappeared 
leaving behind not even a hair of beard,
without a first breakfast, a second or a third;
whispers say that he returned to his place of birth. 
But alas, no hobbit ever saw the fellow again,
and so, with the best weed and the pipe most plain,
they sometimes meet, under the summery sun,
to enjoy a good smoke and pun,
in honor of the fellow,
who decided to stay mellow,
despite being lost, and alone,
adventurous and a bit injury prone. 

The one that smoked and then was just gone.

You earmark the page and close the book, baffled.

>read book
You open the green book at the page you previously earmarked.

This is the story of the fellow from out of time and space 

There was, once upon a time,
a young lost fellow without dime.
Taken by a book, he said
but the hobbits just thought him mad.
He looked around, and he went east,
then west, then back, then flew on a great beast.
For the life of him he could not remember,
how he came to be or if it was July or December.
He spoke with many, fought with few, 
but in the end, he decided to just enjoy the view.
 He rolled his weed, sat on a chair,
took out his pipe and smoked without flair.

Here ends the story of the young fellow,
he sure must have been relaxed and mellow,
because soon he disappeared 
leaving behind not even a hair of beard,
without a first breakfast, a second or a third;
whispers say that he returned to his place of birth. 
But alas, no hobbit ever saw the fellow again,
and so, with the best weed and the pipe most plain,
they sometimes meet, under the summery sun,
to enjoy a good smoke and pun,
in honor of the fellow,
who decided to stay mellow,
despite being lost, and alone,
adventurous and a bit injury prone. 

The one that smoked and then was just gone.

You mumble the rhymes to yourself a couple of times and then close the green book.

* * *

>go to rivendell
Rivendell
At the edge of a narrow gorge, the peaceful elven town of Rivendell seems almost to sit on the river Bruinen. Wherever you are you can hear water streaming by or roaring down steep cliffs. Maybe before exploring you should look for someone to talk to.

You can see an Elf Lord and a pedestal (on which are an old sword and a mithril shirt) here.

>ask elf about sam
Two brave hobbit. lol

>ask elf about sam & pip
I have already answer that

>ask lord
You could ask about him or Sam & Pip.

>ask sam
You can't see any such thing.

>ask lord about sam
I have already answer that

>e
You can't go that way.

>w
shire
Round, colorful doors are set in the sprawling green hills, from the tops of which the smoke of small chimneys hints at homely meals shared at round tables. Some hobbits are venturing the paths between smials, others are enjoying the sun, Gandalf towers above all even while sitting on his favorite chair.

You can see Sam & Pip here.

>ask gandalf about wtf
You really want to take the Eagle to go directly to mount doom ?

Please answer yes or no.

>n
As you please.

* * *

>ask gandalf about wtf
You really want to take the Eagle to go directly to mount doom ?

>y
You are transporting to mount doom be the eagle. You find a easy shortcut ! But wait... it seem that you are to weak for this kind of transport... we need to stop befor you trow up, sorry. You are now in Rivendell...

>showme me
yourself - person
    Ring
    lighter
location: in Rivendell
singular-named, proper-named; unlit, inedible, portable; male, visible
list grouping key: none
printed name: "yourself"
printed plural name: "people"
indefinite article: none
description: "As good-looking as ever."
initial appearance: none
carrying capacity: 100

>showme gandalf
Gandalf - caracter
location: in Rivendell
singular-named, proper-named; unlit, inedible, portable; male, visible
list grouping key: none
printed name: "Gandalf"
printed plural name: "caracters"
indefinite article: none
description: none
initial appearance: none
carrying capacity: 100
Responses Table: Table of Gandalf Responses
Seconde Responses Table: Table of Seconde Gandalf Responses
Answered List: WTF

>ask gandalf
You could ask about him, something, or WTF.

* * *

>go to the shire
Shire
Round, colorful doors are set in the sprawling green hills, from the tops of which the smoke of small chimneys hints at homely meals shared at round tables. Some hobbits are venturing the paths between smials, others are enjoying the sun. Gandalf towers above all even while sitting on his favorite chair. You can see Sam & Pip lounging on the grass.

>ask gandalf about life
You shall not distract yourself with nonsensical and philosophical questions. If you are here to waste my time, go read a book.

>ask gandalf about the ring
The object that you now have in your possession has many names Frodo: the One Ring, Isidur's Bane, the Ring of Power. It is a very dark and very powerful artifact, one that can only be destroyed where it was created: in the fire of Mount Doom.

>ask gandalf about mount doom
The great volcano lies south of here, beyond the mountains. It is the only place where the ring may be vanquished, the final destination to your adventure. I could accompany you there… may I suggest we use the Eagles? They are great beasts and should take us to Mount Doom in no time at all. Would you like to leave right now?

>y
An easy shortcut! How lucky you are!
 You mount on a beautiful Eagle and soon you find yourself flying above the green Shire. Is that really Sam down there, he looks so little, so small, maybe a little too miniscule. Are we sure we are safe flying so high? DON'T LOOK DOWN, DON'T…

It looks like you are too weak for this mode of transportation, we should stop before you throw up on yourself and the Eagle (she might eat you, they really like to keep themselves clean).
You are now in Rivendell...

Rivendell
At the edge of a narrow gorge, the peaceful elven town of Rivendell seems almost to sit on the river Bruinen. Wherever you are you can hear water streaming by or roaring down steep cliffs. Maybe before exploring you should look for someone to talk to.

You can see an Elf Lord and a pedestal (on which are an old sword and a mithril shirt) here.

>ask gandalf about the elf council
They shall decide of your destiny Frodo, if after the Great Eagle Fail (as it is now known) they decide that you shan't continue, I would not blame them.

>ask gandalf ybout me
I only understood you as far as wanting to ask Gandalf.

>ask gandalf about me
Never in my life have I seen someone look so green. I brought you to Rivendell before you threw up on poor Mildred, she was not happy.

>ask gandalf about Mount Doom
Yeah yeah, i'm busy little boy, stop asking me the same question again and again please.

* * *

>go to the shire
Shire
Round, colorful doors are set in the sprawling green hills, from the tops of which the smoke of small chimneys hints at homely meals shared at round tables. Some hobbits are venturing the paths between smials, others are enjoying the sun. Gandalf towers above all even while sitting on his favorite chair. You can see Sam & Pip lounging on the grass.

>ask gandalf about the weather
A lovely summery day, Frodo. The shadows of war are far but getting closer, soon even the Shire will know the end of its peace.

>ask gandalf
You could ask about him, me, Mount Doom, the weather, life, books, pipe-weed, or the ring.

>ask sam
You could ask about them, pipe-weed, or the quest.

* * *

>go to the shire
Shire
Round, colorful doors are set in the sprawling green hills, from the tops of which the smoke of small chimneys hints at homely meals shared at round tables. Some hobbits are venturing the paths between smials, others are enjoying the sun. Gandalf towers above all even while sitting on his favorite chair. You can see Sam & Pip lounging on the grass.

>go to bag end
Bag End
You find yourself in a cavernicolous and airy room. Doors, windows and ceilings are round, like if someone has carved holes in the earth itself. Outside you can hear the laughter of children and the chirping of birds.

You can see a little table (on which are a green book and a map), a trunk (closed), and a cupboard here.

>open book
It isn't something you can open.

>read book
You open the green book at a random page.

This is the story of the fellow from out of time and space 

There was, once upon a time,
a young lost fellow without dime.
Taken by a book, he said
but the hobbits just thought him mad.
He looked around, and he went east,
then west, then back, then flew on a great beast.
For the life of him he could not remember,
how he came to be or if it was July or December.
He spoke with many, fought with few, 
but in the end, he decided to just enjoy the view.
 He rolled his weed, sat on a chair,
took out his pipe and smoked without flair.

Here ends the story of the young fellow,
he sure must have been relaxed and mellow,
because soon he disappeared 
leaving behind not even a hair of beard,
without a first breakfast, a second or a third;
whispers say that he returned to his place of birth. 
But alas, no hobbit ever saw the fellow again,
and so, with the best weed and the pipe most plain,
they sometimes meet, under the summery sun,
to enjoy a good smoke and pun,
in honor of the fellow,
who decided to stay mellow,
despite being lost, and alone,
adventurous and a bit injury prone. 

The one that smoked and then was just gone.

You earmark the page and close the book, baffled.

>go out
Shire
Round, colorful doors are set in the sprawling green hills, from the tops of which the smoke of small chimneys hints at homely meals shared at round tables. Some hobbits are venturing the paths between smials, others are enjoying the sun. Gandalf towers above all even while sitting on his favorite chair. You can see Sam & Pip lounging on the grass.

>talk to Gandalf
To start a conversation, you need to use ASK Gandalf ABOUT something. Type "ask Gandalf (about)" to see the available's topic.

>ask gandalf about mount doom
The great volcano lies south of here, beyond the mountains. It is the only place where the ring may be vanquished, the final destination to your adventure. I could accompany you there… may I suggest we use the Eagles? They are great beasts and should take us to Mount Doom in no time at all. Would you like to leave right now?

* * *

>talk to gandalf about mount doom
I only understood you as far as wanting to talk to Gandalf.

>ask gandalf about mount doom
Are you ok Frodo? You seem to be more stupid than usual...

* * *

>go to the shire
Shire
Round, colorful doors are set in the sprawling green hills, from the tops of which the smoke of small chimneys hints at homely meals shared at round tables. Some hobbits are venturing the paths between smials, others are enjoying the sun. Gandalf towers above all even while sitting on his favorite chair. You can see Sam & Pip lounging on the grass.

>showme the shire
Shire - room
singular-named, improper-named; lighted, unvisited
list grouping key: none
printed name: "Shire"
printed plural name: none
indefinite article: none
description: "DESCRIPTION"

* * *

>i
You are carrying:
  a Ring
  a lighter

>e
Rivendell
At the edge of a narrow gorge, the peaceful elven town of Rivendell seems almost to sit on the river Bruinen. Wherever you are you can hear water streaming by or roaring down steep cliffs. Maybe before exploring you should look for someone to talk to.

You can see an Elf Lord and a pedestal (on which are an old sword and a mithril shirt) here.

>go to old room
old room
Something here calls to you, like a whisper in the wind or the faint rustling of the worn pages of a well-loved book. Around and above you the walls are covered in paint. Scattered scenes chase each other without order or thought, a majestic blue dragon flies over mountain peaks, a great lion roars at the foot of a white castle and on the ceiling someone too small to be a man smiles forlornly, behind him ships ready to sail in the unknown.

You can see an old table (on which is a mysterious book) here.

>read book
...One Ring to rule them all, One Ring to find them, One Ring to bring them all and in the darkness bind them In the Land of Mordor where the Shadows lie...

What happend ??

Bag End
You find yourself in a cavernicolous and airy room. Doors, windows and ceilings are round, like if someone has carved holes in the earth itself.

>showme me
yourself - person
    Ring
    lighter
location: in the Bag End
singular-named, proper-named; unlit, inedible, portable; male, visible
list grouping key: none
printed name: "yourself"
printed plural name: "people"
indefinite article: none
description: "As good-looking as ever."
initial appearance: none
carrying capacity: 100

>read book
You can't see any such thing.

I beg your pardon?

>outside
shire
Round, colorful doors are set in the sprawling green hills, from the tops of which the smoke of small chimneys hints at homely meals shared at round tables. Some hobbits are venturing the paths between smials, others are enjoying the sun, Gandalf towers above all even while sitting on his favorite chair.

You can see Sam & Pip here.

* * *

>ask gandalf about him
My name is Gandalf, I'm a magicien.

>ask gandalf about his name
The answer is in the BOOK ! You fool...

>ask gandalf
You could ask about him, something, or WTF.

>ask sam about test
Of course I do, I everything fine?Sam & Pip give you a nice hobbit tabaco...

>i
You are carrying:
  Weed
  a Ring
  a lighter

>smoke weed
You light Weed with your lighter and inhale deeply. And you find yourself teleported to Mount Doom!

Mount Doom
The heat is blistering, suffocating. Somewhere belove you licks of flame run along barren rock and molten lava churns at the mouth of the active volcano.  The ring hisses, dark things, promises of power and greed, it would even implore and beg if it was capable of such a thing.  
 This could be the end of your story, the end of your adventure, will there be ships to whisk you away once you throw the ring to the flames of Mount Doom?

>showme me
yourself - person
    Ring
    lighter
location: in Mount Doom
singular-named, proper-named; unlit, inedible, portable; male, visible
list grouping key: none
printed name: "yourself"
printed plural name: "people"
indefinite article: none
description: "As good-looking as ever."
initial appearance: none
carrying capacity: 100

* * *

>i
You are carrying:
  a Ring
  a lighter

>take book
You can't see any such thing.

* * *

>n
You can't go that way.

>e
You can't go that way.

>s
You can't go that way.

>w
You can't go that way.

* * *

>open book
Holding your breath, you carefully open the book.

"...One Ring to rule them all, One Ring to find them,
One Ring to bring them all and in the darkness bind them.
In the Land of Mordor where the Shadows lie..."

You can barely make out a few sentences before words and letters begin to move in concentric swirls. You try to take a step back, but your fingers are stuck to the pages. WOOOOOSH. A great wind pulls at you and the only thing you can do is scream and scream in terror. You look one last time at the beautiful paintings on the walls and then everything goes black.  
 

Bag End
You find yourself in a cavernicolous and airy room. Doors, windows and ceilings are round, like if someone has carved holes in the earth itself. Outside you can hear the laughter of children and the chirping of birds.

You can see a little table (on which are a green book and a map), a trunk (closed), and a cupboard here.

I beg your pardon?

>open book
You open the green book at a random page.

This is the story of the fellow from out of time and space 

There was, once upon a time,
a young lost fellow without dime.
Taken by a book, he said
but the hobbits just thought him mad.
He looked around, and he went east,
then west, then back, then flew on a great beast.
For the life of him he could not remember,
how he came to be or if it was July or December.
He spoke with many, fought with few, 
but in the end, he decided to just enjoy the view.
 He rolled his weed, sat on a chair,
took out his pipe and smoked without flair.

Here ends the story of the young fellow,
he sure must have been relaxed and mellow,
because soon he disappeared 
leaving behind not even a hair of beard,
without a first breakfast, a second or a third;
whispers say that he returned to his place of birth. 
But alas, no hobbit ever saw the fellow again,
and so, with the best weed and the pipe most plain,
they sometimes meet, under the summery sun,
to enjoy a good smoke and pun,
in honor of the fellow,
who decided to stay mellow,
despite being lost, and alone,
adventurous and a bit injury prone. 

The one that smoked and then was just gone.

You earmark the page and close the book, baffled.

>x map
Pretty old, it was probably drawn by hand. You are not an expert, but you should be able to read it.

>x book
As green as fine summery grass, the title of the book stands boldly on its front " Surviving Your First High and Other Ways to Have the Best Time of Your Life With Weed ".

* * *

>read book
Holding your breath, you carefully open the book.

"...One Ring to rule them all, One Ring to find them,
One Ring to bring them all and in the darkness bind them.
In the Land of Mordor where the Shadows lie..."

You can barely make out a few sentences before words and letters begin to move in concentric swirls. You try to take a step back, but your fingers are stuck to the pages.
WOOOOOSH
 A great wind pulls at you and the only thing you can do is scream and scream in terror. You look one last time at the beautiful paintings on the walls and then everything goes black.  
 

Bag End
You find yourself in a cavernicolous and airy room. Doors, windows and ceilings are round, like if someone has carved holes in the earth itself. Outside you can hear the laughter of children and the chirping of birds.

You can see a little table (on which are a green book and a map), a trunk (closed), and a cupboard here.

* * *

>go outside
Shire
Round, colorful doors are set in the sprawling green hills, from the tops of which the smoke of small chimneys hints at homely meals shared at round tables. Some hobbits are venturing the paths between smials, others are enjoying the sun. Gandalf towers above all even while sitting on his favorite chair. You can see Sam & Pip lounging on the grass.

>Ask sam about test
Of course I do, I everything fine?Sam & Pip give you a nice hobbit tabaco...

>i
You are carrying:
  pipe-weed
  a Ring

>e pipe-weed
I only understood you as far as wanting to (go) e Sam & Pip.

>exmaine weed
That's not a verb I recognize.

>examine weed
You see nothing special about pipe-weed.

>i
You are carrying:
  pipe-weed
  a Ring

>smoke weed
How do you plane to doing it... with your hand ? A pipe may be a good idea.

>smoke pipe-weed
How do you plane to doing it... with your hand ? A pipe may be a good idea.

>go inside
Bag End
You find yourself in a cavernicolous and airy room. Doors, windows and ceilings are round, like if someone has carved holes in the earth itself.

You can see a little table (on which are a little book and a map), a trunk (closed), and a cupboard here.

>open trunk
You open the trunk, revealing a pipe and a bag of money.

>smoke weed
How do you plane to doing it... with your hand ? A pipe may be a good idea.

>take the pipe
Taken.

>smoke weed
You light pipe-weed with your lighter and inhale deeply. And you find yourself teleported to Mount Doom!

Mount Doom
The heat is blistering, suffocating. Somewhere belove you licks of flame run along barren rock and molten lava churns at the mouth of the active volcano.  The ring hisses, dark things, promises of power and greed, it would even implore and beg if it was capable of such a thing.  
 This could be the end of your story, the end of your adventure, will there be ships to whisk you away once you throw the ring to the flames of Mount Doom?

* * *

>go outside
Shire
Round, colorful doors are set in the sprawling green hills, from the tops of which the smoke of small chimneys hints at homely meals shared at round tables. Some hobbits are venturing the paths between smials, others are enjoying the sun. Gandalf towers above all even while sitting on his favorite chair. You can see Sam & Pip lounging on the grass.

>ask about
You can't see any such thing.

>ask gandalf
You could ask about him, me, the weather, life, books, pipe-weed, the ring, or the quest.

>ask gandalf about me
Did you smoke something? Are you alright? Is this some sort of test? You are Frodo Baggins, of course, hobbit of the Shire.

>ask gandalf about him
I am Gandalf the Grey. I was sent to Middle Earth to help destroy the ring that you now hold. I am an Istar , a wizard of old.

>ask gandalf about him
Are you ok Frodo? You seem to be more stupid than usual...

>ask gandalf about the quest
A great adventure that will take you to places unknown. A long time ago the ring you now hold was created by Sauron, a great evil, to rule over Middle Earth. After a bloody war the ring was cut from its master's hand and lost to the ages. Somehow your uncle Bilbo found it and passed it on to you Frodo. You are the one, the chosen, he who must go to Mount Doom and destroy the ring once and for all. Before the world is plunged in darkness.

>ask gandalf about
You could ask about him, me, the weather, life, books, pipe-weed, the ring, the quest, or Mount Doom.

>ask gandalf about life
You shall not distract yourself with nonsensical and philosophical questions. If you are here to waste my time, go read a book.

* * *

I beg your pardon?

* * *

>ask gandalf about
 You could ask Gandalf about you.

>ask about me
You can't see any such thing.

>ask gandalf about
 You could ask Gandalf about you.

* * *

>ask gandalf about me
"Sire, who I am ?"... Did you smoke something? Are you alright? Is this some sort of test? You are Frodo Baggins, of course, hobbit of the Shire.

Now you could also ask Gandalf about him, the weather, or life.

>ask Gandalf about me
I d'ont see what you mean, sorry.

>ask gandalf about him
I am Gandalf the Grey. I was sent to Middle Earth to help destroy the ring that you now hold. I am an Istar , a wizard of old.

>ask gandalf about life
You shall not distract yourself with nonsensical and philosophical questions. If you are here to waste my time, go read a book.

Now you could also ask Gandalf about books, pipe-weed, or the quest.

>ask gandalf about
 You could ask Gandalf about the weather, books, pipe-weed, or the quest.

>ask gandalf about quest
I d'ont see what you mean, sorry.

>ask gandalf about the quest
A great adventure that will take you to places unknown. A long time ago the ring you now hold was created by Sauron, a great evil, to rule over Middle Earth. After a bloody war the ring was cut from its master's hand and lost to the ages. Somehow your uncle Bilbo found it and passed it on to you Frodo. You are the one, the chosen, he who must go to Mount Doom and destroy the ring once and for all. Before the world is plunged in darkness.

Now you could also ask Gandalf about the ring or Mount Doom.

* * *

>ask gandalf about Mount Doom
The great volcano lies south of here, beyond the mountains. It is the only place where the ring may be vanquished, the final destination to your adventure. I could accompany you there… may I suggest we use the Eagles? They are great beasts and should take us to Mount Doom in no time at all. Would you like to leave right now?

>y
An easy shortcut! How lucky you are!
 You mount on a beautiful Eagle and soon you find yourself flying above the green Shire. Is that really Sam down there, he looks so little, so small, maybe a little too miniscule. Are we sure we are safe flying so high? DON'T LOOK DOWN, DON'T…

It looks like you are too weak for this mode of transportation, we should stop before you throw up on yourself and the Eagle (she might eat you, they really like to keep themselves clean).
You are now in Rivendell...

Rivendell
At the edge of a narrow gorge, the peaceful elven town of Rivendell seems almost to sit on the river Bruinen. Wherever you are you can hear water streaming by or roaring down steep cliffs. Maybe before exploring you should look for someone to talk to.

You can see Gandalf, an Elf Lord, and a pedestal (on which are an old sword and a mithril shirt) here.

>ask gandalf about
 You could ask Gandalf about me, Rivendell
, Mildred, or the quest.

>ask gandalf about the quest
The Elf Council is still in session. I think you should wait and hear what they have to say.

Now you could also ask Gandalf about the Elf Council or Mount Doom.

>ask gandalf about
 You could ask Gandalf about me, Rivendell
, Mildred, the Elf Council, or Mount Doom.

* * *

>ask gandalf about
 You could ask Gandalf about you.

>ask gandalf about me
Did you smoke something? Are you alright? Is this some sort of test? You are Frodo Baggins, of course, hobbit of the Shire.

>ask gandalf about me
I d'ont see what you mean, sorry.

>ask gandalf about
You could ask about the weather, the quest, him, or life.

>ask gandalf about life
You shall not distract yourself with nonsensical and philosophical questions. If you are here to waste my time, go read a book.

>ask gandalf about
You could ask about the weather, the quest, him, books, pipe-weed, or the ring.

>ask gandalf about the ring
The object that you now have in your possession has many names Frodo: the One Ring, Isidur's Bane, the Ring of Power. It is a very dark and very powerful artifact, one that can only be destroyed where it was created: in the fire of Mount Doom.

*** Run-time problem P25: Attempt to choose a blank row in a table with none left: table 'Table of Gandalf Responses'.

* * *

>ask gandalf about
 You could ask Gandalf about you.

>ask gandalf about the quest
A great adventure that will take you to places unknown. A long time ago the ring you now hold was created by Sauron, a great evil, to rule over Middle Earth. After a bloody war the ring was cut from its master's hand and lost to the ages. Somehow your uncle Bilbo found it and passed it on to you Frodo. You are the one, the chosen, he who must go to Mount Doom and destroy the ring once and for all. Before the world is plunged in darkness.

* * *

I beg your pardon?

>showme Table of Gandalf Responses
There seems to be no such object anywhere in the model world.

>showme Table of Eagle Fail
There seems to be no such object anywhere in the model world.

* * *

>go outside
Shire
Round, colorful doors are set in the sprawling green hills, from the tops of which the smoke of small chimneys hints at homely meals shared at round tables. Some hobbits are venturing the paths between smials, others are enjoying the sun. Gandalf towers above all even while sitting on his favorite chair. You can see Sam & Pip lounging on the grass.

>ask gandalf about me
Did you smoke something? Are you alright? Is this some sort of test? You are Frodo Baggins, of course, hobbit of the Shire.

*** Run-time problem P25: Attempt to choose a blank row in a table with none left: table 'Table of Gandalf Responses'.

>ask gandalf about
You could ask about the weather or life.

>ask gandalf about him
I d'ont see what you mean, sorry.

* * *

>go outside
Shire
Round, colorful doors are set in the sprawling green hills, from the tops of which the smoke of small chimneys hints at homely meals shared at round tables. Some hobbits are venturing the paths between smials, others are enjoying the sun. Gandalf towers above all even while sitting on his favorite chair. You can see Sam & Pip lounging on the grass.

>ask gandalf about the quest
A great adventure that will take you to places unknown. A long time ago the ring you now hold was created by Sauron, a great evil, to rule over Middle Earth. After a bloody war the ring was cut from its master's hand and lost to the ages. Somehow your uncle Bilbo found it and passed it on to you Frodo. You are the one, the chosen, he who must go to Mount Doom and destroy the ring once and for all. Before the world is plunged in darkness.

>ask gandalf about
You could ask about him, me, the weather, life, books, pipe-weed, the ring, the quest, Mount Doom, 
*** Run-time problem P23: Attempt to look up a non-existent entry at column 3, row 10 of the table 'Table of Gandalf Responses'.

, or .

>ask gandalf about the quest
I already gave you the answer! You fool...

* * *

>go outside
Shire
Round, colorful doors are set in the sprawling green hills, from the tops of which the smoke of small chimneys hints at homely meals shared at round tables. Some hobbits are venturing the paths between smials, others are enjoying the sun. Gandalf towers above all even while sitting on his favorite chair. You can see Sam & Pip lounging on the grass.

>ask sam about the quest
"Oh, you mean the ring? The one that you should destroy? That is some serious business Pip, don't you think?"
 "Very serious, Sam…"
. "Well, I guess as your friends we should accompany and make sure you don't get eaten by an orc."
 "We are such good friends…where should we start Sam?"
 "Maybe with the Elves? I think Rivendell lies east of here, should we go there Frodo? I think they could help."

* * *

Please answer yes or no.

>y
The road is long, but Sam & Pip are good company. You share every meal, sing the songs of the Shire when you feel too tired to think and, in the end, you make your way to the elf's city of Rivendell, where the Elf Council is deliberating on if and how much to help you in your quest.

Rivendell
At the edge of a narrow gorge, the peaceful elven town of Rivendell seems almost to sit on the river Bruinen. Wherever you are you can hear water streaming by or roaring down steep cliffs. Maybe before exploring you should look for someone to talk to.

You can see Sam & Pip, an Elf Lord, and a pedestal (on which are an old sword and a mithril shirt) here.

>w
Shire
Round, colorful doors are set in the sprawling green hills, from the tops of which the smoke of small chimneys hints at homely meals shared at round tables. Some hobbits are venturing the paths between smials, others are enjoying the sun. Gandalf towers above all even while sitting on his favorite chair.

>ask gandalf about
You could ask about me, the weather, or the quest.

>ask gandalf about quest
I d'ont see what you mean, sorry.

I beg your pardon?

>ask gandalf about the quest
A great adventure that will take you to places unknown. A long time ago the ring you now hold was created by Sauron, a great evil, to rule over Middle Earth. After a bloody war the ring was cut from its master's hand and lost to the ages. Somehow your uncle Bilbo found it and passed it on to you Frodo. You are the one, the chosen, he who must go to Mount Doom and destroy the ring once and for all. Before the world is plunged in darkness.

>ask gandalf about
You could ask about me, the weather, or Mount Doom.

>ask gandalf about mount doom
The great volcano lies south of here, beyond the mountains. It is the only place where the ring may be vanquished, the final destination to your adventure. I could accompany you there… may I suggest we use the Eagles? They are great beasts and should take us to Mount Doom in no time at all. Would you like to leave right now?

Please answer yes or no.

>ask Gandalf about me
Please answer yes or no.

>ask Gandalf about
Please answer yes or no.

>ask Gandalf about life
Please answer yes or no.

>ask Gandalf about the weather
Please answer yes or no.

>ask Gandalf about
Please answer yes or no.

* * *

I beg your pardon?

>ask gandalf about
You could ask about him, me, the weather, life, books, pipe-weed, the ring, or 
*** Run-time problem P23: Attempt to look up a non-existent entry at column 3, row 8 of the table 'Table of Gandalf Responses'.

.

* * *

>go outside
Shire
Round, colorful doors are set in the sprawling green hills, from the tops of which the smoke of small chimneys hints at homely meals shared at round tables. Some hobbits are venturing the paths between smials, others are enjoying the sun. Gandalf towers above all even while sitting on his favorite chair. You can see Sam & Pip lounging on the grass.

>go in bag end
You can't see any such thing.

>go inside
Bag End
You find yourself in a cavernicolous and airy room. Doors, windows and ceilings are round, like if someone has carved holes in the earth itself. Outside you can hear the laughter of children and the chirping of birds.

You can see a little table (on which are a green book and a map), a trunk (closed), and a cupboard here.

>read map
Incredibly detailed, it is signed by one of your ancestors. Bag End stands proudly (if a bit larger than the scale would allow), in the middle of the Shire. To the east you can see great mountains and the city of Rinvendell and in the south, encased in a smudge of black ink, there is Mount Doom.

>x book
You see nothing special about the green book.

>read book
You open the green book at a random page.

 This is the story of the fellow from out of time and space 

There was, once upon a time,
a young lost fellow without dime.
Taken by a book, he said
but the hobbits just thought him mad.
He looked around, and he went east,
then west, then back, then flew on a great beast.
For the life of him he could not remember,
how he came to be or if it was July or December.
He spoke with many, fought with few, 
but in the end, he decided to just enjoy the view.
 He rolled his weed, sat on a chair,
took out his pipe and smoked without flair.

Here ends the story of the young fellow,
he sure must have been relaxed and mellow,
because soon he disappeared 
leaving behind not even a hair of beard,
without a first breakfast, a second or a third;
whispers say that he returned to his place of birth. 
But alas, no hobbit ever saw the fellow again,
and so, with the best weed and the pipe most plain,
they sometimes meet, under the summery sun,
to enjoy a good smoke and pun,
in honor of the fellow,
who decided to stay mellow,
despite being lost, and alone,
adventurous and a bit injury prone. 

The one that smoked and then was just gone.

* * *

>show me Sam
You can't see any such thing.

>showme sam
Sam & Pip - caracter
location: in the Shire
singular-named, proper-named; unlit, inedible, portable; male
list grouping key: none
printed name: "Sam & Pip"
printed plural name: "caracters"
indefinite article: none
description: none
initial appearance: none
carrying capacity: 100

>showme lord
Elf Lord - thing
location: in Rivendell
singular-named, improper-named; unlit, inedible, portable
list grouping key: none
printed name: "Elf Lord"
printed plural name: none
indefinite article: none
description: none
initial appearance: none

* * *

>show me the trunk
You can't see any such thing.

>showme trunk
trunk - open container
    pipe
    bag of money
location: in the bilbo's home out of play
singular-named, improper-named; unlit, inedible, portable; opaque, open, unopenable, unlocked
list grouping key: none
printed name: "trunk"
printed plural name: "containers"
indefinite article: none
description: none
initial appearance: none
carrying capacity: 100

>shoeme bilbo
That's not a verb I recognise.

>showme bilbo
There seems to be no such object anywhere in the model world.

>shwome bilbo's home
That's not a verb I recognise.

>showme bilbo's home
bilbo's home - open container
    little table - supporter
        little book
        map
    trunk - open container
        pipe
        bag of money
    cupboard
location: out of play
singular-named, improper-named; unlit, inedible, portable; opaque, open, unopenable, unlocked
list grouping key: none
printed name: "bilbo's home"
printed plural name: "containers"
indefinite article: none
description: none
initial appearance: none
carrying capacity: 100

* * *

>showme trunk
trunk - open container
    pipe
    bag of money
location: in the bilbo's home out of play
singular-named, improper-named; unlit, inedible, portable; opaque, open, unopenable, unlocked
list grouping key: none
printed name: "trunk"
printed plural name: "containers"
indefinite article: none
description: none
initial appearance: none
carrying capacity: 100

>showme weed
weed - thing
location: out of play
singular-named, proper-named; unlit, inedible, portable
list grouping key: none
printed name: "weed"
printed plural name: none
indefinite article: none
description: "DESCRIPTION"
initial appearance: none

* * *

>showme bilbo's house
Bilbo's House - room
singular-named, proper-named; lighted, unvisited
list grouping key: none
printed name: "Bilbo's House"
printed plural name: none
indefinite article: none
description: "DESCRIPTION"

* * *

>showme book
book - thing
location: on the table in the room
singular-named, improper-named; unlit, inedible, portable
list grouping key: none
printed name: "book"
printed plural name: none
indefinite article: none
description: none
initial appearance: none

* * *

>showme gandalf
Gandalf - caracter
location: in the shire
singular-named, proper-named; unlit, inedible, portable; male, visible
list grouping key: none
printed name: "Gandalf"
printed plural name: "caracters"
indefinite article: none
description: none
initial appearance: none
carrying capacity: 100
Responses Table: Table of Gandalf Responses
Seconde Responses Table: Table of Seconde Gandalf Responses
Answered List:

>go to shire
shire
Round, colorful doors are set in the sprawling green hills, from the tops of which the smoke of small chimneys hints at homely meals shared at round tables. Some hobbits are venturing the paths between smials, others are enjoying the sun, Gandalf towers above all even while sitting on his favorite chair.

You can see Sam & Pip here.

>ask gandalf
You could ask about him, something, or WTF.

>go rivendell
You can't see any such thing.

>e
Rivendell
At the edge of a narrow gorge, the peaceful elven town of Rivendell seems almost to sit on the river Bruinen. Wherever you are you can hear water streaming by or roaring down steep cliffs. Maybe before exploring you should look for someone to talk to.

You can see an Elf Lord and a pedestal (on which are an old sword and a mithril shirt) here.

>ask elf
You could ask about him or Gandalf.

* * *

>ask elf about his life
I'm the Elf lord little boy.

>ask elf
You could ask about him or Gandalf.

>ask elf about gandalf
Gandalf is a fool.

* * *

>showme little table
little table - supporter
    little book
    map
location: in the bilbo's home out of play
singular-named, improper-named; unlit, inedible, fixed in place; list grouping key: none
printed name: "little table"
printed plural name: "supporters"
indefinite article: none
description: none
initial appearance: none
carrying capacity: 100

>showme pedestal
pedestal - supporter
    old sword
    shirt in chainmail
location: in Rivendell
singular-named, improper-named; unlit, inedible, fixed in place; list grouping key: none
printed name: "pedestal"
printed plural name: "supporters"
indefinite article: none
description: none
initial appearance: none
carrying capacity: 100

* * *

>showme lord
Elf Lord - caracter
location: in Rivendell
singular-named, improper-named; unlit, inedible, portable; male
list grouping key: none
printed name: "Elf Lord"
printed plural name: "caracters"
indefinite article: none
description: none
initial appearance: none
carrying capacity: 100

* * *

>showme ring
Ring - thing
location: out of play
singular-named, improper-named; unlit, inedible, portable
list grouping key: none
printed name: "Ring"
printed plural name: none
indefinite article: none
description: none
initial appearance: "DESCRIPTION"

* * *

>showme shire
Shire - room
    Gandalf - caracter
    Sam & Pip - caracter
singular-named, improper-named; lighted, unvisited
list grouping key: none
printed name: "Shire"
printed plural name: none
indefinite article: none
description: "DESCRIPTION"

* * *

>showme stack
There seems to be no such object anywhere in the model world.

>showme weed
There seems to be no such object anywhere in the model world.

* * *

>showme supporter
(the old table)
old table - supporter
    old book
location: in the Old Room
singular-named, improper-named; unlit, inedible, fixed in place; list grouping key: none
printed name: "old table"
printed plural name: "supporters"
indefinite article: none
description: none
initial appearance: none
carrying capacity: 100

>showme pedestal
pedestal - supporter
location: in Rivendell
singular-named, improper-named; unlit, inedible, fixed in place; list grouping key: none
printed name: "pedestal"
printed plural name: "supporters"
indefinite article: none
description: none
initial appearance: none
carrying capacity: 100

>showme trunk
trunk - open container
    pipe
    bag of money
location: in the bilbo's home out of play
singular-named, improper-named; unlit, inedible, portable; opaque, open, unopenable, unlocked
list grouping key: none
printed name: "trunk"
printed plural name: "containers"
indefinite article: none
description: none
initial appearance: none
carrying capacity: 100

* * *

>showme weed
Weed - thing
location: out of play
singular-named, proper-named; unlit, inedible, portable
list grouping key: none
printed name: "Weed"
printed plural name: none
indefinite article: none
description: none
initial appearance: "DESCRIPTION"

>showme gandalf
Gandalf - thing
location: in the Shire
singular-named, proper-named; unlit, inedible, portable
list grouping key: none
printed name: "Gandalf"
printed plural name: none
indefinite article: none
description: none
initial appearance: none

* * *

>showme weed
Weed - thing
location: out of play
singular-named, proper-named; unlit, inedible, portable
list grouping key: none
printed name: "Weed"
printed plural name: none
indefinite article: none
description: none
initial appearance: "DESCRIPTION"

>showme stack of weed
There seems to be no such object anywhere in the model world.

* * *

>take book
You can't see any such thing.

>showme table
table - supporter
    book
location: out of play
singular-named, improper-named; unlit, inedible, fixed in place; list grouping key: none
printed name: "table"
printed plural name: "supporters"
indefinite article: none
description: none
initial appearance: none
carrying capacity: 100

* * *

>talk gandalf about him
I didn't understand that sentence.

>talk to gandalf
To start a conversation, you need to use ASK Gandalf ABOUT something. Type "ask Gandalf (about)" to see the available's topic.

>ask Gandalf about him
My name is Gandalf, I'm a magicien.

>ask Gandalf about him
I already answered to this question.

>ask Gandalf about him
I already answered to this question.

>showme gandalf
Gandalf - caracter
location: in the shire
singular-named, proper-named; unlit, inedible, portable; male, visible
list grouping key: none
printed name: "Gandalf"
printed plural name: "caracters"
indefinite article: none
description: none
initial appearance: none
carrying capacity: 100
Responses Table: Table of Gandalf Responses
Answered List: him

I beg your pardon?

>ask Gandalf about wtf
You really want to take the Eagle to go directly to mount doom ?

>n
As you please.

>ask Gandalf about wtf
You really want to take the Eagle to go directly to mount doom ?

* * *

>n
As you please.

>ask sam about him
My name is Sam, I'm a perfect teammate.Glulxe fatal error: Memory access out of range (1E025C0F)

* * *

>talk to gandalf
To start a conversation, you need to use ASK Gandalf ABOUT something. Type "ask Gandalf (about)" to see the available's topic.

>ask gandalf about wtf
Of course I do, I everything fine?

>ask gandalf about
Please answer yes or no.

>ask gandalf about him
Please answer yes or no.

>yes
You are transporting to mount doom be the eagle. You find a easy shortcut ! But wait... it seem that you are to weak for this kind of transport... we need to stop befor you trow up, sorry.
Rivendell
DESCRIPTION

You can see an Elf Lord and a pedestal (on which are an old sword and a shirt in chainmail) here.

* * *

>teleport to
What do you want to teleport to?

>teleport to bilbo's house
You can't see any such thing.

* * *

>teleport to
What do you want to teleport to?

>teleport to house
You can't see any such thing.

>go inside
Bilbo's House
DESCRIPTION

You can see a little table (on which are a little book and a map), a trunk (in which are a pipe and a bag of money), and a cupboard here.

* * *

>teleport to mount doom
You can't see any such thing.

>teleport to rivendell
You can't see any such thing.

>teleport to gandalf
You can't see any such thing.

* * *

>teleport to reviendell
You can't see any such thing.

>teleport to rivendell
You can't see any such thing.

>w
Bilbo's House
DESCRIPTION

You can see a little table (on which are a little book and a map), a trunk (in which are a pipe and a bag of money), and a cupboard here.

>teleport to trunk
people can only travel between location

>showme rivendell
Rivendell - room
    Elf Lord - caracter
    pedestal - supporter
        old sword
        shirt in chainmail
singular-named, proper-named; lighted, unvisited
list grouping key: none
printed name: "Rivendell"
printed plural name: none
indefinite article: none
description: "DESCRIPTION"
map region: story

* * *

>teleport to rivendell
You can't see any such thing.

>teleport to book
You can't see any such thing.

>teleport to book
You can't see any such thing.

>teleport to weed
You can't see any such thing.

* * *

>teleport to shire
You can't see any such thing.

>teleport to table
people can only travel between location

* * *

>teleport to shrine
You can't see any such thing.

* * *

>teleport to table
You can't see any such thing.

* * *

>teleport to the shire
You can't see any such thing.

* * *

>teleport to trunk
You can't see any such thing.

>teleport to book
people can only travel between location

>teleport to shire
You can't see any such thing.

* * *

>teleport to trunk
You can't see any such thing.

>teleport to shire
You can't see any such thing.

>teleport to book
people can only travel between location

* * *

>teleprot to shrine
That's not a verb I recognise.

>teleport to shrine
You can't see any such thing.

>teleport to shire
You can't see any such thing.

>teleport to shire
You can't see any such thing.

* * *

>w
Bilbo's House
DESCRIPTION

You can see a little table (on which are a little book and a map), a trunk (in which are a pipe and a bag of money), and a cupboard here.

>teleport to the little table
wow! the little table
Bilbo's House (on the little table)
DESCRIPTION

You can see a trunk (in which are a pipe and a bag of money) and a cupboard here.

On the little table you can see a little book and a map.

wow!

>teleport to shire
You can't see any such thing.

>teleport to the shire
You can't see any such thing.

>teleport to the trunk
wow! the trunk
Bilbo's House (in the trunk)
DESCRIPTION

You can see a little table (on which are a little book and a map) and a cupboard here.

In the trunk you can see a pipe and a bag of money.

wow!

>teleport to bilbo's house
You can't see any such thing.

* * *

>x book
A hardback book, it's red cover frayed at the edges. If it weren't for the golden script on the spine no one would look twice at it. The title is enclosed in a circle: "The Fellowship of the Ring", underneath a name known by most: "J. R. R. Tolkien".

>open book
Holding your breath, you carefully open the book.

"...One Ring to rule them all, One Ring to find them,
One Ring to bring them all and in the darkness bind them.
In the Land of Mordor where the Shadows lie..."

You can barely make out a few sentences before words and letters begin to move in concentric swirls. You try to take a step back, but your fingers are stuck to the pages.
WOOOOOSH
 A great wind pulls at you and the only thing you can do is scream and scream in terror. You look one last time at the beautiful paintings on the walls and then everything goes black.  
 

Bag End
You find yourself in a cavernicolous and airy room. Doors, windows and ceilings are round, like if someone has carved holes in the earth itself. Outside you can hear the laughter of children and the chirping of birds.

You can see a little table (on which are a green book and a map), a trunk (closed), and a cupboard here.