Lord of the Read
An Interactive Fiction by Simon, Tessa and Marcela
Release 1 / Serial number 210604 / Inform 7 build 6M62 (I6/v6.34 lib 6/12N) SD

Old room
Something here calls to you, like a whisper in the wind or the faint rustling of the worn pages of a well-loved book. Around and above you the walls are covered in paint. You can't seem to remember how you made it here. There are no doors, no way for you to get out, not even a window to suggest where in the world you are.

You can see an old table (on which is a mysterious book) here.

>burn ring
You can't see any such thing.

>read book
Holding your breath, you carefully open the book.

"...One Ring to rule them all, One Ring to find them,
One Ring to bring them all and in the darkness bind them.
In the Land of Mordor where the Shadows lie..."

You can barely make out a few sentences before words and letters begin to move in concentric swirls. You try to take a step back, but your fingers are stuck to the pages.
WOOOOOSH
 A great wind pulls at you and the only thing you can do is scream and scream in terror. You look one last time at the beautiful paintings on the walls and then everything goes black.

Bag End
You find yourself in a cavernicolous and airy room. Doors, windows and ceilings are round, like if someone has carved holes in the earth itself. Outside you can hear the laughter of children and the chirping of birds.

You can see a little table (on which are a green book and a map), a trunk (closed), a cupboard (closed), and a cushy armchair here.

>burn ring
The Ring can't be destroy ! But that's the spirit...

>cut the ring
The Ring can't be destroy !

>destroy the ring
The Ring can't be destroy !

>go to mount doom
Mount Doom
The heat is blistering, suffocating. Somewhere below you licks of flames run along barren rock and molten lava churns at the mouth of the active volcano.  The ring hisses, dark things, promises of power and greed, it would even implore and beg if it was capable of such a thing. This could be the end of your story, the end of your adventure, will there be ships to whisk you away once you throw the ring to the flames of Mount Doom?

>jump into the lava
I only understood you as far as wanting to jump.

>jump into the lava
I only understood you as far as wanting to jump.

* * *

Lord of the Read
An Interactive Fiction by Simon, Tessa and Marcela
Release 1 / Serial number 210604 / Inform 7 build 6M62 (I6/v6.34 lib 6/12N) SD

Old room
Something here calls to you, like a whisper in the wind or the faint rustling of the worn pages of a well-loved book. Around and above you the walls are covered in paint. You can't seem to remember how you made it here. There are no doors, no way for you to get out, not even a window to suggest where in the world you are.

You can see an old table (on which is a mysterious book) here.

>go to bag end
Bag End
You find yourself in a cavernicolous and airy room. Doors, windows and ceilings are round, like if someone has carved holes in the earth itself. Outside you can hear the laughter of children and the chirping of birds.

You can see a little table (on which are a green book and a map), a trunk (closed), a cupboard (closed), and a cushy armchair here.

>open cupboard
You open the cupboard, revealing a loaf of bread, an apple, and a peach.

>eat apple
You eat the apple with gusto.

>eat peach
You eat the peach with gusto.

>eat bread
Such a thick and crunchy crust! You cannot resist and eat the whole thing in three gigantic bites.

* * *

>go to bag end
Bag End
You find yourself in a cavernicolous and airy room. Doors, windows and ceilings are round, like if someone has carved holes in the earth itself. Outside you can hear the laughter of children and the chirping of birds.

You can see a little table (on which are a green book and a map), a trunk (closed), a cupboard (closed), and a cushy armchair here.

>open trunk
You open the trunk, revealing a pipe and a bag of money.

I beg your pardon?

>take pipe
Taken.

>smoke pipe
It's empty unfortunately.

>go outside
Shire
Round, colorful doors are set in the sprawling green hills, from the tops of which the smoke of small chimneys hints at homely meals shared at round tables. Some hobbits are venturing the paths between smials, others are enjoying the sun. Gandalf towers above all even while sitting on his favorite chair. You can see Sam & Pip lounging on the grass.

>ask gandalf
 You could ask Gandalf about you.

>talk to gandalf
To start a conversation, you need to use ASK Gandalf ABOUT something. Type "ask Gandalf (about)" to see the available topics.

>ask gandalf about
 You could ask Gandalf about you.

>ask gandalf
 You could ask Gandalf about you.

>ask gandalf (about)
I only understood you as far as wanting to ask Gandalf.

* * *

>go to bag end
Bag End
You find yourself in a cavernicolous and airy room. Doors, windows and ceilings are round, like if someone has carved holes in the earth itself. Outside you can hear the laughter of children and the chirping of birds.

You can see a little table (on which are a green book and a map), a trunk (closed), a cupboard (closed), and a cushy armchair here.

>take trunk
That's fixed in place.

>take cupboard
That's fixed in place.

* * *

Lord of the Read
An Interactive Fiction by Simon, Tessa and Marcela
Release 1 / Serial number 210604 / Inform 7 build 6M62 (I6/v6.34 lib 6/12N) SD

Old room
Something here calls to you, like a whisper in the wind or the faint rustling of the worn pages of a well-loved book. Around and above you the walls are covered in paint. You can't seem to remember how you made it here. There are no doors, no way for you to get out, not even a window to suggest where in the world you are.

You can see an old table (on which is a mysterious book) here.

>go to mount doom
Mount Doom
The heat is blistering, suffocating. Somewhere below you licks of flames run along barren rock and molten lava churns at the mouth of the active volcano.  Even through you smoked out brain you remember that there was something important, something you should do here, a ring maybe? You did not forget the ring somewhere, right? RIGHT?!

>go to rivendell
Rivendell
At the edge of a narrow gorge, the peaceful elven town of Rivendell seems almost to sit on the river Bruinen. Wherever you are you can hear water streaming by or roaring down steep cliffs. Maybe before exploring you should look for someone to talk to.

You can see an Elf Lord and a pedestal (on which are an old sword and a mithril shirt) here.

It is now 9:02 am. Wait until Elf Council begins little bit from now.

* * *

>go to mount doom
Mount Doom
The heat is blistering, suffocating. Somewhere below you licks of flames run along barren rock and molten lava churns at the mouth of the active volcano.  Even through you smoked out brain you remember that there was something important, something you should do here, a ring maybe? You did not forget the ring somewhere, right? RIGHT?!

>throw me into the lava
That would probably work if you were, you know, actually carrying the ring.

* * *

>go to mount doom
Mount Doom
The heat is blistering, suffocating. Somewhere below you licks of flames run along barren rock and molten lava churns at the mouth of the active volcano.  Even through you smoked out brain you remember that there was something important, something you should do here, a ring maybe? You did not forget the ring somewhere, right? RIGHT?!

>throw yourself into the lava
You can't see any such thing.

>throw me into the volcano
That would probably work if you were, you know, actually carrying the ring

* * *

>go to mount doom
Mount Doom
The heat is blistering, suffocating. Somewhere below you licks of flames run along barren rock and molten lava churns at the mouth of the active volcano.  Even through you smoked out brain you remember that there was something important, something you should do here, a ring maybe? You did not forget the ring somewhere, right? RIGHT?!

>throw yourself into the volcano
You can't see any such thing.

>throw yourself
You can't see any such thing.

>go to the shire
Shire
Round, colorful doors are set in the sprawling green hills, from the tops of which the smoke of small chimneys hints at homely meals shared at round tables. Some hobbits are venturing the paths between smials, others are enjoying the sun. Gandalf towers above all even while sitting on his favorite chair. You can see Sam & Pip lounging on the grass.

>go inside
Bag End
You find yourself in a cavernicolous and airy room. Doors, windows and ceilings are round, like if someone has carved holes in the earth itself. Outside you can hear the laughter of children and the chirping of birds.

You can see a little table (on which are a green book and a map), a trunk (closed), and a cupboard here.

>open trunk
You open the trunk, revealing a pipe and a bag of money.

>take the pipe
Taken.

>go ouside
You can't see any such thing.

>go outside
Shire
Round, colorful doors are set in the sprawling green hills, from the tops of which the smoke of small chimneys hints at homely meals shared at round tables. Some hobbits are venturing the paths between smials, others are enjoying the sun. Gandalf towers above all even while sitting on his favorite chair. You can see Sam & Pip lounging on the grass.

>ask sam about them
Frodo did you hit your head? I'm Sam, that's Pip, we have been friends for ages.

Now you could also ask Sam & Pip about pipe-weed or the quest.

>ask sam about pipe
Well…we stole, I mean borrowed! We borrowed some from old Dinodas while he was drunk. Would you like some?
Sam & Pip give you some nice pipe-weed.

>ask sam about weed
I d'ont see what you mean, sorry.

>ask sam about pip-weed
I d'ont see what you mean, sorry.

>ask sam about pipe-weed
We would prefer to smoke rather than answering you again and again

>i
You are carrying:
  Pipe-weed
  a pipe

>smoke weed
You light Pipe-weed with your lighter and inhale deeply. And you find yourself teleported to Mount Doom!

Mount Doom
The heat is blistering, suffocating. Somewhere belove you licks of flame run along barren rock and molten lava churns at the mouth of the active volcano.  Even through you smoked out brain you remember that there was something important, something you should do here, a ring maybe? You di not forget the ring somewhere, right? RIGHT?!  
 This could be the end of your story, the end of your adventure, will there be ships to whisk you away once you throw the ring to the flames of Mount Doom?

You can see a volcano (empty) here.

    *** bad answer ***

Would you like to RESTART, RESTORE a saved game, QUIT, or UNDO the last command?

* * *

Lord of the Read
An Interactive Fiction by Simon, Tessa and Marcela
Release 1 / Serial number 210604 / Inform 7 build 6M62 (I6/v6.34 lib 6/12N) SD

Old room
Something here calls to you, like a whisper in the wind or the faint rustling of the worn pages of a well-loved book. Around and above you the walls are covered in paint. You can't seem to remember how you made it here. There are no doors, no way for you to get out, not even a window to suggest where in the world you are.

You can see an old table (on which is a mysterious book) here.

>go to revendell
That noun did not make sense in this context.

>go to Rivendell
Rivendell
At the edge of a narrow gorge, the peaceful elven town of Rivendell seems almost to sit on the river Bruinen. Wherever you are you can hear water streaming by or roaring down steep cliffs. Maybe before exploring you should look for someone to talk to.

You can see an Elf Lord and a pedestal (on which are an old sword and a mithril shirt) here.

It is now 9:01 am. Wait until Council begins at 9:15.

>z
Time passes.

It is now 9:02 am. Wait until Council begins at 9:15.

>z
Time passes.

It is now 9:03 am. Wait until Council begins at 9:15.

>z
Time passes.

It is now 9:04 am. Wait until Council begins at 9:15.

>z
Time passes.

It is now 9:05 am. Wait until Council begins at 9:15.

>z
Time passes.

It is now 9:06 am. Wait until Council begins at 9:15.

>z
Time passes.

It is now 9:07 am. Wait until Council begins at 9:15.

>z
Time passes.

It is now 9:08 am. Wait until Council begins at 9:15.

>z
Time passes.

It is now 9:09 am. Wait until Council begins at 9:15.

>z
Time passes.

It is now 9:10 am. Wait until Council begins at 9:15.

>z
Time passes.

It is now 9:11 am. Wait until Council begins at 9:15.

>z
Time passes.

It is now 9:12 am. Wait until Council begins at 9:15.

>z
Time passes.

It is now 9:13 am. Wait until Council begins at 9:15.

>z
Time passes.

It is now 9:14 am. Wait until Council begins at 9:15.

>z
Time passes.

It is now 9:15 am. Wait until Council begins at 9:15.

>z
Time passes.

It is now 9:16 am. Wait until Council begins at 9:15.

Council starts now!

* * *

Lord of the Read
An Interactive Fiction by Simon, Tessa and Marcela
Release 1 / Serial number 210604 / Inform 7 build 6M62 (I6/v6.34 lib 6/12N) SD

Old room
Something here calls to you, like a whisper in the wind or the faint rustling of the worn pages of a well-loved book. Around and above you the walls are covered in paint. You can't seem to remember how you made it here. There are no doors, no way for you to get out, not even a window to suggest where in the world you are.

You can see an old table (on which is a mysterious book) here.

>go to rivendel
That noun did not make sense in this context.

>go to rivendell
Rivendell
At the edge of a narrow gorge, the peaceful elven town of Rivendell seems almost to sit on the river Bruinen. Wherever you are you can hear water streaming by or roaring down steep cliffs. Maybe before exploring you should look for someone to talk to.

You can see an Elf Lord and a pedestal (on which are an old sword and a mithril shirt) here.

>take mithril shirt
Taken.

>put mithril shirt on
You can't wear that!

* * *

Lord of the Read
An Interactive Fiction by Simon, Tessa and Marcela
Release 1 / Serial number 210604 / Inform 7 build 6M62 (I6/v6.34 lib 6/12N) SD

Old room
Something here calls to you, like a whisper in the wind or the faint rustling of the worn pages of a well-loved book. Around and above you the walls are covered in paint. You can't seem to remember how you made it here. There are no doors, no way for you to get out, not even a window to suggest where in the world you are.

You can see an old table (on which is a mysterious book) here.

>go to rivendell
Rivendell
At the edge of a narrow gorge, the peaceful elven town of Rivendell seems almost to sit on the river Bruinen. Wherever you are you can hear water streaming by or roaring down steep cliffs. Maybe before exploring you should look for someone to talk to.

You can see an Elf Lord and a pedestal (on which are an old sword and a mithril shirt) here.

The Elf Council is in session now. You should hear from them soon.

>ask elf lord about
 You could ask the Elf Lord about him, Sam & Pip, or Gandalf.

>ask elf lord about him
I am Elrond, Elf Lord of Rivendell. 
Now you could also ask about Elf Council, Rivendell, or Mount Doom.

>ask elf lord about rivendell
My gem, my precious town built on the river Bruinen, the place we came to call home. It a serene place young Frodo and I will not have you disrupt its peace.

A tall lady elf, her hands crossed behind her back, approaches you slowly. Her long dress swishes on the marble pavements. "I am Lady Amarië, messenger to the Elf Council. Your plea for help in your quest has been discussed at long in the sacred halls of the council, the task of the destruction of the ring is one of great importance to all of Middle-Earth. That said, you are an incredibly weak hobbit Frodo Baggins and we do not think that you will be able to make it to Mount Doom and destroy the ring before Sauron finds you. You are unworthy, we will not help. In a few hundred years, maybe, a brave hobbit will be born to your line, one who will withstand the journey and its perils. In the meantime I advise you to go back to the Shire (west) and enjoy a quiet and peaceful life." She turns around and slowly walks away. You would say something but you're pretty sure your jaw has hit the floor at some point.

>ask elf lord about elf council
The decision of the Elf Council is final and I have to admit I feel somewhat relived that you were not the one chosen for such a task. Go back to the Shire (west), Frodo, enjoy life, have many children, I am sure one of them will be up to the task.

Now you could also ask about the quest or The ring.

>ask elf lord about the quest
Do not insist, hobbit, the Elf Council has deemed you unworthy.

>go west
Shire
Round, colorful doors are set in the sprawling green hills, from the tops of which the smoke of small chimneys hints at homely meals shared at round tables. Some hobbits are venturing the paths between smials, others are enjoying the sun. Gandalf towers above all even while sitting on his favorite chair. You can see Sam & Pip lounging on the grass.

* * *

>go to rivendell
Rivendell
At the edge of a narrow gorge, the peaceful elven town of Rivendell seems almost to sit on the river Bruinen. Wherever you are you can hear water streaming by or roaring down steep cliffs. Maybe before exploring you should look for someone to talk to.

You can see an Elf Lord and a pedestal (on which are an old sword and a mithril shirt) here.

The Elf Council is in session now. You should hear from them soon.

>go to bag end
Bag End
You find yourself in a cavernicolous and airy room. Doors, windows and ceilings are round, like if someone has carved holes in the earth itself. Outside you can hear the laughter of children and the chirping of birds.

You can see a little table (on which are a green book and a map), a trunk (closed), a cupboard (closed), and a cushy armchair here.

>take book
Taken.

>go to rinvendell
That noun did not make sense in this context.

>go to rivendell
Rivendell
At the edge of a narrow gorge, the peaceful elven town of Rivendell seems almost to sit on the river Bruinen. Wherever you are you can hear water streaming by or roaring down steep cliffs. Maybe before exploring you should look for someone to talk to.

You can see an Elf Lord and a pedestal (on which are an old sword and a mithril shirt) here.

A tall lady elf, her hands crossed behind her back, approaches you slowly. Her long dress swishes on the marble pavements. "I am Lady Amarië, messenger to the Elf Council. Your plea for help in your quest has been discussed at long in the sacred halls of the council, the task of the destruction of the ring is one of great importance to all of Middle-Earth. That said, you are an incredibly weak hobbit Frodo Baggins and we do not think that you will be able to make it to Mount Doom and destroy the ring before Sauron finds you. You are unworthy, we will not help. In a few hundred years, maybe, a brave hobbit will be born to your line, one who will withstand the journey and its perils. In the meantime I advise you to go back to the Shire (west) and enjoy a quiet and peaceful life." She turns around and slowly walks away. You would say something but you're pretty sure your jaw has hit the floor at some point.

>put ring on pedestal
You can't see any such thing.

>put book on pedestal
You put the green book on the pedestal.

>go to bag end
Bag End
You find yourself in a cavernicolous and airy room. Doors, windows and ceilings are round, like if someone has carved holes in the earth itself. Outside you can hear the laughter of children and the chirping of birds.

You can see a little table (on which is a map), a trunk (closed), a cupboard (closed), and a cushy armchair here.

>take map
Taken.

>go to rivendell
Rivendell
At the edge of a narrow gorge, the peaceful elven town of Rivendell seems almost to sit on the river Bruinen. Wherever you are you can hear water streaming by or roaring down steep cliffs. Maybe before exploring you should look for someone to talk to.

You can see an Elf Lord and a pedestal (on which are a green book, an old sword, and a mithril shirt) here.

>put map on pedestal
There is no more room on the pedestal.

* * *

>go to rivendell
Rivendell
At the edge of a narrow gorge, the peaceful elven town of Rivendell seems almost to sit on the river Bruinen. Wherever you are you can hear water streaming by or roaring down steep cliffs. Maybe before exploring you should look for someone to talk to.

You can see an Elf Lord and a pedestal (on which are an old sword and a mithril shirt) here.

The Elf Council is in session now. You should hear from them soon.

>put mithril shirt on
(first taking the mithril shirt)
You put on the mithril shirt.

* * *

>go to rivendell
Rivendell
At the edge of a narrow gorge, the peaceful elven town of Rivendell seems almost to sit on the river Bruinen. Wherever you are you can hear water streaming by or roaring down steep cliffs. Maybe before exploring you should look for someone to talk to.

You can see an Elf Lord and a pedestal (on which are an old sword and a mithril shirt) here.

The Elf Council is in session now. You should hear from them soon.

>w
wait the council !

>w
wait the council !

>w
wait the council !

Council starts now!

>w
Shire
Round, colorful doors are set in the sprawling green hills, from the tops of which the smoke of small chimneys hints at homely meals shared at round tables. Some hobbits are venturing the paths between smials, others are enjoying the sun. Gandalf towers above all even while sitting on his favorite chair. You can see Sam & Pip lounging on the grass.

>e
Rivendell
At the edge of a narrow gorge, the peaceful elven town of Rivendell seems almost to sit on the river Bruinen. Wherever you are you can hear water streaming by or roaring down steep cliffs. Maybe before exploring you should look for someone to talk to.

You can see an Elf Lord and a pedestal (on which are an old sword and a mithril shirt) here.

>z
Time passes.

I beg your pardon?

>z
Time passes.

>z
Time passes.

>throw the ring into lava
You can't see any such thing.

>i
You are carrying nothing.

* * *

>go to rivendell
Rivendell
At the edge of a narrow gorge, the peaceful elven town of Rivendell seems almost to sit on the river Bruinen. Wherever you are you can hear water streaming by or roaring down steep cliffs. Maybe before exploring you should look for someone to talk to.

You can see an Elf Lord and a pedestal (on which are an old sword and a mithril shirt) here.

The Elf Council is in session now. You should hear from them soon.

>z
Time passes.

It is now 9:02 am. Wait until Elf Council begins little bit from now.

>z
Time passes.

It is now 9:03 am. Wait until Elf Council begins little bit from now.

>z
Time passes.

It is now 9:04 am. Wait until Elf Council begins little bit from now.

Council starts now!

>z
Time passes.

It is now 9:05 am. Wait until Elf Council begins at 7 minutes.

>z
Time passes.

It is now 9:06 am. Wait until 12:00 am, though.

>z
Time passes.

It is now 9:07 am. Wait until 12:00 am, though.

>z
Time passes.

It is now 9:08 am. Wait until 12:00 am, though.

>z
Time passes.

It is now 9:09 am. Wait until 12:00 am, though.

>z
Time passes.

It is now 9:10 am. Wait until 12:00 am, though.

>z
Time passes.

It is now 9:11 am. Wait until 12:00 am, though.

>z
Time passes.

It is now 9:12 am. Wait until 12:00 am, though.

>z
Time passes.

It is now 9:13 am. Wait until 12:00 am, though.

>z
Time passes.

It is now 9:14 am. Wait until 12:00 am, though.

>z
Time passes.

It is now 9:15 am. Wait until 12:00 am, though.

>z
Time passes.

It is now 9:16 am. Wait until 12:00 am, though.

wombat!

* * *

Lord of the Read
An Interactive Fiction by Simon, Tessa and Marcela
Release 1 / Serial number 210604 / Inform 7 build 6M62 (I6/v6.34 lib 6/12N) SD

Old room
Something here calls to you, like a whisper in the wind or the faint rustling of the worn pages of a well-loved book. Around and above you the walls are covered in paint. You can't seem to remember how you made it here. There are no doors, no way for you to get out, not even a window to suggest where in the world you are.

You can see an old table (on which is a mysterious book) here.

>go to the shire
Shire
Round, colorful doors are set in the sprawling green hills, from the tops of which the smoke of small chimneys hints at homely meals shared at round tables. Some hobbits are venturing the paths between smials, others are enjoying the sun. Gandalf towers above all even while sitting on his favorite chair. You can see Sam & Pip lounging on the grass.

>ask sam about them
Frodo did you hit your head? I'm Sam, that's Pip, we have been friends for ages.

Now you could also ask Sam & Pip about pipe-weed or the quest.

>ask sam about the quest
"Oh, you mean the ring? The one that you should destroy? That is some serious business Pip, don't you think?"
 "Very serious, Sam…"
. "Well, I guess as your friends we should accompany and make sure you don't get eaten by an orc."
 "We are such good friends…where should we start Sam?"
 "Maybe with the Elves? I think Rivendell lies east of here, should we go there Frodo? I think they could help."

>y
The road is long, but Sam & Pip are good company. You share every meal, sing the songs of the Shire when you feel too tired to think and, in the end, you make your way to the elf's city of Rivendell, where the Elf Council is deliberating on if and how much to help you in your quest.

Rivendell
At the edge of a narrow gorge, the peaceful elven town of Rivendell seems almost to sit on the river Bruinen. Wherever you are you can hear water streaming by or roaring down steep cliffs. Maybe before exploring you should look for someone to talk to.

You can see Sam & Pip, an Elf Lord, and a pedestal (on which are an old sword and a mithril shirt) here.

>z
Time passes.

>z
Time passes.

Council starts now!

>z
Time passes.

>e
You can't go that way.

>w
Shire
Round, colorful doors are set in the sprawling green hills, from the tops of which the smoke of small chimneys hints at homely meals shared at round tables. Some hobbits are venturing the paths between smials, others are enjoying the sun. Gandalf towers above all even while sitting on his favorite chair.

>e
Rivendell
At the edge of a narrow gorge, the peaceful elven town of Rivendell seems almost to sit on the river Bruinen. Wherever you are you can hear water streaming by or roaring down steep cliffs. Maybe before exploring you should look for someone to talk to.

You can see Sam & Pip, an Elf Lord, and a pedestal (on which are an old sword and a mithril shirt) here.

>z
Time passes.

* * *

Lord of the Read
An Interactive Fiction by Simon, Tessa and Marcela
Release 1 / Serial number 210604 / Inform 7 build 6M62 (I6/v6.34 lib 6/12N) SD

Old room
Something here calls to you, like a whisper in the wind or the faint rustling of the worn pages of a well-loved book. Around and above you the walls are covered in paint. You can't seem to remember how you made it here. There are no doors, no way for you to get out, not even a window to suggest where in the world you are.

You can see an old table (on which is a mysterious book) here.

>open book
Holding your breath, you carefully open the book.

"...One Ring to rule them all, One Ring to find them,
One Ring to bring them all and in the darkness bind them.
In the Land of Mordor where the Shadows lie..."

You can barely make out a few sentences before words and letters begin to move in concentric swirls. You try to take a step back, but your fingers are stuck to the pages.
WOOOOOSH
 A great wind pulls at you and the only thing you can do is scream and scream in terror. You look one last time at the beautiful paintings on the walls and then everything goes black.

Bag End
You find yourself in a cavernicolous and airy room. Doors, windows and ceilings are round, like if someone has carved holes in the earth itself. Outside you can hear the laughter of children and the chirping of birds.

You can see a little table (on which are a green book and a map), a trunk (closed), a cupboard (closed), and a cushy armchair here.

>burn ring
The Ring can only be destroyed by the fiery pits of Mount Doom. But that's the spirit...

>read map
Incredibly detailed, it is signed by one of your ancestors. Bag End stands proudly (if a bit larger than the scale would allow), in the middle of the Shire. To the east you can see great mountains and the city of Rivendell and in the south, encased in a smudge of black ink, there is Mount Doom.

>go to rivendell
Rivendell
At the edge of a narrow gorge, the peaceful elven town of Rivendell seems almost to sit on the river Bruinen. Wherever you are you can hear water streaming by or roaring down steep cliffs. Maybe before exploring you should look for someone to talk to.

You can see an Elf Lord and a pedestal (on which are an old sword and a mithril shirt) here.

The Elf Council is in session now. You should hear from them soon.

>put mithril shirt on
You take the mithril shirt but...

... you are not sure about the utility of wearing it.

* * *

>drop ring
Dropped.

>go to mount doom
Mount Doom
The heat is blistering, suffocating. Somewhere below you licks of flames run along barren rock and molten lava churns at the mouth of the active volcano.  Even through you smoked out brain you remember that there was something important, something you should do here, a ring maybe? You did not forget the ring somewhere, right? RIGHT?!

>go to the shire
Shire
Round, colorful doors are set in the sprawling green hills, from the tops of which the smoke of small chimneys hints at homely meals shared at round tables. Some hobbits are venturing the paths between smials, others are enjoying the sun. Gandalf towers above all even while sitting on his favorite chair. You can see Sam & Pip lounging on the grass.

>ask sam about them
Frodo did you hit your head? I'm Sam, that's Pip, we have been friends for ages.

Now you could also ask about pipe-weed or the quest.

>ask sam about pipeweed
I don't see what you mean, sorry.

>ask sam about weed
"Well…we stole, I mean borrowed! We borrowed some from old Dinodas while he was drunk. Would you like some?"

Sam & Pip give you some nice pipe-weed.

>go inside
Bag End
You find yourself in a cavernicolous and airy room. Doors, windows and ceilings are round, like if someone has carved holes in the earth itself. Outside you can hear the laughter of children and the chirping of birds.

You can see The Ring, a little table (on which are a green book and a map), a trunk (closed), a cupboard (closed), and a cushy armchair here.

>open trunk
You open the trunk, revealing a pipe and a bag of money.

>take pipe
Taken.

>smoke weed
You light Pipe-weed with your lighter and inhale deeply. You can almost feel the air moving inside your lungs, Pipe-weed sinking deep in your blood and your brain. Life is such a strange and wonderous thing and what matters if you're stuck inside a version of Lord of the Rings where everyone treats you like an idiot? You know how this story begins and ends, if you could just turn to one of the last chapters, you could show them, show them all how the story of Frodo Baggins should have gone. You can see the pages in your mind, you turn and turn and turn them…and you find yourself teleported to Mount Doom!

Mount Doom
The heat is blistering, suffocating. Somewhere below you licks of flames run along barren rock and molten lava churns at the mouth of the active volcano.  Even through you smoked out brain you remember that there was something important, something you should do here, a ring maybe? You did not forget the ring somewhere, right? RIGHT?! 

    *** 

GAME OVER.

 You somehow managed to forget the central element to the whole story (which, might we remind you, is called "The Fellowship of the RING"). We wish to thank you in any case for having played, it has been fun (for us at least).

 All the best to you, dear player, and if you want to try again, just remember to not forget the ring. Good luck! ***

Would you like to RESTART, RESTORE a saved game, QUIT, or UNDO the last command?

* * *

>drop ring
Dropped.

>open trunk
You open the trunk, revealing a pipe and a bag of money.

* * *

>take pipe
Taken.

>go outside
Shire
Round, colorful doors are set in the sprawling green hills, from the tops of which the smoke of small chimneys hints at homely meals shared at round tables. Some hobbits are venturing the paths between smials, others are enjoying the sun. Gandalf towers above all even while sitting on his favorite chair. You can see Sam & Pip lounging on the grass.

* * *

>ask sam about them
Frodo did you hit your head? I'm Sam, that's Pip, we have been friends for ages.

Now you could also ask Sam & Pip about pipe-weed or the quest.

>ask sam about weed
"Well…we stole, I mean borrowed! We borrowed some from old Dinodas while he was drunk. Would you like some?"
Sam & Pip give you some nice pipe-weed.

>smoke weed
You light Pipe-weed with your lighter and inhale deeply. You can almost feel the air moving inside your lungs, Pipe-weed sinking deep in your blood and your brain. Life is such a strange and wonderous thing and what matters if you're stuck inside a version of Lord of the Rings where everyone treats you like an idiot? You know how this story begins and ends, if you could just turn to one of the last chapters, you could show them, show them all how the story of Frodo Baggins should have gone. You can see the pages in your mind, you turn and turn and turn them…and you find yourself teleported to Mount Doom!

Mount Doom
The heat is blistering, suffocating. Somewhere belove you licks of flame run along barren rock and molten lava churns at the mouth of the active volcano.  Even through you smoked out brain you remember that there was something important, something you should do here, a ring maybe? You did not forget the ring somewhere, right? RIGHT?! 

You can see a volcano (empty) here.

    *** 

GAME OVER.

 You somehow managed to forget the central element to the whole story (which, might we remind you, is called "The Fellowship of the RING"). We wish to thank you in any case for having played, it has been fun (for us at least).

 All the best to you, dear player, and if you want to try again, just remember to not forget the ring. Good luck! ***

Would you like to RESTART, RESTORE a saved game, QUIT, or UNDO the last command?

* * *

>go outside
Shire
Round, colorful doors are set in the sprawling green hills, from the tops of which the smoke of small chimneys hints at homely meals shared at round tables. Some hobbits are venturing the paths between smials, others are enjoying the sun. Gandalf towers above all even while sitting on his favorite chair. You can see Sam & Pip lounging on the grass.

>ask gandalf about me
"Sir, who I am?"... Did you smoke something? Are you alright? Is this some sort of test? You are Frodo Baggins, of course, hobbit of the Shire.

Now you could also ask about him, the weather, or life.

>ask gandalf about life
You shall not distract yourself with nonsensical and philosophical questions. If you are here to waste my time, go read a book.

Now you could also ask about books, pipe-weed, or the quest.

>ask gandalf about the quest
A great adventure that will take you to places unknown. A long time ago the ring you now hold was created by Sauron, a great evil, to rule over Middle Earth. After a bloody war the ring was cut from its master's hand and lost to the ages. Somehow your uncle Bilbo found it and passed it on to you Frodo. You are the one, the chosen, he who must go to Mount Doom and destroy the ring once and for all. Before the world is plunged in darkness.

Now you could also ask about the ring or Mount Doom.

>ask gandalf about mt doom
I d'ont see what you mean, sorry.

>ask gandalf about Mount Doom
The great volcano lies south of here, beyond the mountains. It is the only place where the ring may be vanquished, the final destination to your adventure. I could accompany you there… may I suggest we use the Eagles? They are great beasts and should take us to Mount Doom in no time at all. Would you like to leave right now?

>y
An easy shortcut! How lucky you are!
 You mount on a beautiful Eagle and soon you find yourself flying above the green Shire. Is that really Sam down there, he looks so little, so small, maybe a little too miniscule. Are we sure we are safe flying so high? DON'T LOOK DOWN, DON'T…

It looks like you are too weak for this mode of transportation, we should stop before you throw up on yourself and the Eagle (she might eat you, they really like to keep themselves clean).
You are now in Rivendell...

Rivendell
At the edge of a narrow gorge, the peaceful elven town of Rivendell seems almost to sit on the river Bruinen. Wherever you are you can hear water streaming by or roaring down steep cliffs. Maybe before exploring you should look for someone to talk to.

You can see an Elf Lord and a pedestal (on which are an old sword and a mithril shirt) here.

The Elf Council is in session now. You should hear from them soon.

Gandalf is following you.

*** Run-time problem P23: Attempt to look up a non-existent entry at column 4, row 6 of the table 'Table of Gandalf Responses'.

* * *

>go outside
Shire
Round, colorful doors are set in the sprawling green hills, from the tops of which the smoke of small chimneys hints at homely meals shared at round tables. Some hobbits are venturing the paths between smials, others are enjoying the sun. Gandalf towers above all even while sitting on his favorite chair. You can see Sam & Pip lounging on the grass.

>ask sam about me
I d'ont see what you mean, sorry.

>ask sam about
 You could ask Sam & Pip about them.

>ask sam about them
Frodo did you hit your head? I'm Sam, that's Pip, we have been friends for ages.

Now you could also ask about pipe-weed or the quest.

>ask sam about the quest
"Oh, you mean the ring? The one that you should destroy? That is some serious business Pip, don't you think?"
 "Very serious, Sam…"
. "Well, I guess as your friends we should accompany and make sure you don't get eaten by an orc."
 "We are such good friends…where should we start Sam?"
 "Maybe with the Elves? I think Rivendell lies east of here, should we go there Frodo? I think they could help."

Please answer yes or no.

>y
The road is long, but Sam & Pip are good company. You share every meal, sing the songs of the Shire when you feel too tired to think and, in the end, you make your way to the elf's city of Rivendell, where the Elf Council is deliberating on if and how much to help you in your quest.

>go east
Rivendell
At the edge of a narrow gorge, the peaceful elven town of Rivendell seems almost to sit on the river Bruinen. Wherever you are you can hear water streaming by or roaring down steep cliffs. Maybe before exploring you should look for someone to talk to.

You can see an Elf Lord and a pedestal (on which are an old sword and a mithril shirt) here.

The Elf Council is in session now. You should hear from them soon.

Sam & Pip followed you.

* * *

>go outside
Shire
Round, colorful doors are set in the sprawling green hills, from the tops of which the smoke of small chimneys hints at homely meals shared at round tables. Some hobbits are venturing the paths between smials, others are enjoying the sun. Gandalf towers above all even while sitting on his favorite chair. You can see Sam & Pip lounging on the grass.

>ask sam about them
Frodo did you hit your head? I'm Sam, that's Pip, we have been friends for ages.

Now you could also ask about pipe-weed or the quest.

>ask sam about pipe-weed
"Well…we stole, I mean borrowed! We borrowed some from old Dinodas while he was drunk. Would you like some?"

Sam & Pip give you some nice pipe-weed.

>yes
That was a rhetorical question.

>go nowhere
You can't see any such thing.

>act confused
That's not a verb I recognize.

>go east
This is the way for Rivendell, but history doesn't want you to go into the woods alone, sorry.

* * *

>ask sam about them
Frodo did you hit your head? I'm Sam, that's Pip, we have been friends for ages.

Now you could also ask about pipe-weed or the quest.

>ask sam about the quest
"Oh, you mean the ring? The one that you should destroy? That is some serious business Pip, don't you think?"
 "Very serious, Sam…"
 "Dangerous as well, I have heard stories of orcs lying in wait to eat unassuming hobbits."
 "Maybe it would be better to ask someone for help, but who?"
 "What about the Elves? I think Rivendell lies east of here, they could probably help."
 "Well Sam, we cannot really send him out there alone, now, can we?"
 "Of course Pip, you're right. Should we accompany you Frodo?"

>y
You can now go east, to the elven city of Rivendell. As it should be, Sam & Pip will accompany you on this great adventure.

* * *

>ask sam about them
Frodo did you hit your head? I'm Sam, that's Pip, we have been friends for ages.

Now you could also ask about pipe-weed or the quest.

>ask sam anout the quest
I only understood you as far as wanting to ask Sam & Pip.

>ask sam about the quest
"Oh, you mean the ring? The one that you should destroy? That is some serious business Pip, don't you think?"
 "Very serious, Sam…"
 "Dangerous as well, I have heard stories of orcs lying in wait to eat unassuming hobbits."
 "Maybe it would be better to ask someone for help, but who?"
 "What about the Elves? I think Rivendell lies east of here, they could probably help."
 "Well Sam, we cannot really send him out there alone, now, can we?"
 "Of course Pip, you're right. Should we accompany you Frodo?"

>n
As you please.

>go east
This is the way for Rivendell, but history doesn't want you to go into the woods alone, sorry.

* * *

>go to mt doom
That noun did not make sense in this context.

>go to mount doom
Mount Doom
The heat is blistering, suffocating. Somewhere below you licks of flame run along barren rock and molten lava churns at the mouth of the active volcano.  The ring hisses, dark things, promises of power and greed, it would even implore and beg if it was capable of such a thing. This could be the end of your story, the end of your adventure, will there be ships to whisk you away once you throw the ring to the flames of Mount Doom?

>throw ring in the flames
The ring fights you; it thrashes in your fingers, it implores, in its whispered hisses, but you manage to throw it into the lava. You see it slowly melt away in the fires of the volcano. A great weight seems to have lifted from your shoulders.

    *** Despite the blistering and suffocating heat a great wind suddenly picks up. You know this feeling of being pulled in different directions, your hair flipping wildly about. 

WOOOOOSH

You find yourself in the old room, the beautiful paintings are still there, as is the book, now closed and resting, unassuming, on the table. One thing is different, though, one thing has changed. There is a door now, a simple wooden door that you open with almost giddy satisfaction. As soon as you are outside you breathe a sigh of relief.
Isn't this library just beautiful? You came in here looking for your favorite book and you somehow got lost in between the racks. There was a…door? You turn around but all you see is a blank wall and nothing more. Mmh…something at the back of your mind whispers of a great adventure…something, with a book...and smoking? You really cannot remember now. Well, it must not be that important. It's time to get something to eat anyway. You leave, never looking back, but feeling somewhat satisfied with yourself. ***

Would you like to RESTART, RESTORE a saved game, QUIT, or UNDO the last command?

* * *

>open green book
You open the green book at a random page.

This is the story of the fellow from out of time and space 

There was, once upon a time,
a young lost fellow without dime.
Taken by a book, he said
but the hobbits just thought him mad.
He looked around, and he went east,
then west, then back, then flew on a great beast.
For the life of him he could not remember,
how he came to be or if it was July or December.
He spoke with many, fought with few, 
but in the end, he decided to just enjoy the view.
 He rolled his weed, sat on a chair,
took out his pipe and smoked without flair.

Here ends the story of the young fellow,
he sure must have been relaxed and mellow,
because soon he disappeared 
leaving behind not even a hair of beard,
without a first breakfast, a second or a third;
whispers say that he returned to his place of birth. 
But alas, no hobbit ever saw the fellow again,
and so, with the best weed and the pipe most plain,
they sometimes meet, under the summery sun,
to enjoy a good smoke and pun,
in honor of the fellow,
who decided to stay mellow,
despite being lost, and alone,
adventurous and a bit injury prone. 

The one that smoked and then was just gone.

You earmark the page and close the book, baffled.

>check
(the Ring)
You see nothing special about the Ring.

>open trunk
You open the trunk, revealing a pipe and a bag of money.

* * *

>take pipe
Taken.

>take money
Taken.

>close trunk
You close the trunk.

>opn trunk
That's not a verb I recognize.

>open trunk
You open the trunk.

>w
You can't go that way.

>e
You can't go that way.

>n
You can't go that way.

>s
You can't go that way.

>check cupboard
You see nothing special about the cupboard.

>i
You are carrying:
  a bag of money
  a pipe
  a Ring

>see
That's not a verb I recognize.

>examining
That's not a verb I recognize.

>looking
That's not a verb I recognize.

>go to
What do you want to go to?

>rivendell
Rivendell
At the edge of a narrow gorge, the peaceful elven town of Rivendell seems almost to sit on the river Bruinen. Wherever you are you can hear water streaming by or roaring down steep cliffs. Maybe before exploring you should look for someone to talk to.

You can see an Elf Lord and a pedestal (on which are an old sword and a mithril shirt) here.

It is now 9:15 am. Wait until 12:00 am, though.

>go to
What do you want to go to?

>mount doom
Mount Doom
The heat is blistering, suffocating. Somewhere belove you licks of flame run along barren rock and molten lava churns at the mouth of the active volcano.  The ring hisses, dark things, promises of power and greed, it would even implore and beg if it was capable of such a thing.  
 This could be the end of your story, the end of your adventure, will there be ships to whisk you away once you throw the ring to the flames of Mount Doom?

>go to rivendell
Rivendell
At the edge of a narrow gorge, the peaceful elven town of Rivendell seems almost to sit on the river Bruinen. Wherever you are you can hear water streaming by or roaring down steep cliffs. Maybe before exploring you should look for someone to talk to.

You can see an Elf Lord and a pedestal (on which are an old sword and a mithril shirt) here.

It is now 9:17 am. Wait until 12:00 am, though.

>time
That's not a verb I recognize.

>check time
You can't see any such thing.

>look
Rivendell
At the edge of a narrow gorge, the peaceful elven town of Rivendell seems almost to sit on the river Bruinen. Wherever you are you can hear water streaming by or roaring down steep cliffs. Maybe before exploring you should look for someone to talk to.

You can see an Elf Lord and a pedestal (on which are an old sword and a mithril shirt) here.

It is now 9:18 am. Wait until 12:00 am, though.

>check time
You can't see any such thing.

>time
That's not a verb I recognize.

>look
Rivendell
At the edge of a narrow gorge, the peaceful elven town of Rivendell seems almost to sit on the river Bruinen. Wherever you are you can hear water streaming by or roaring down steep cliffs. Maybe before exploring you should look for someone to talk to.

You can see an Elf Lord and a pedestal (on which are an old sword and a mithril shirt) here.

It is now 9:19 am. Wait until 12:00 am, though.

>what time is it?
That's not a verb I recognize.

>go
You'll have to say which compass direction to go in.

It is now 9:20 am. Wait until 12:00 am, though.

>go riverdell
You can't see any such thing.

>go rivendell
You can't see any such thing.

>go to Rivendell
Rivendell
At the edge of a narrow gorge, the peaceful elven town of Rivendell seems almost to sit on the river Bruinen. Wherever you are you can hear water streaming by or roaring down steep cliffs. Maybe before exploring you should look for someone to talk to.

You can see an Elf Lord and a pedestal (on which are an old sword and a mithril shirt) here.

It is now 9:21 am. Wait until 12:00 am, though.

>go to
What do you want to go to?

>rivendell
Rivendell
At the edge of a narrow gorge, the peaceful elven town of Rivendell seems almost to sit on the river Bruinen. Wherever you are you can hear water streaming by or roaring down steep cliffs. Maybe before exploring you should look for someone to talk to.

You can see an Elf Lord and a pedestal (on which are an old sword and a mithril shirt) here.

It is now 9:22 am. Wait until 12:00 am, though.

>going to rivendell
That's not a verb I recognize.

>go to Rivendell
Rivendell
At the edge of a narrow gorge, the peaceful elven town of Rivendell seems almost to sit on the river Bruinen. Wherever you are you can hear water streaming by or roaring down steep cliffs. Maybe before exploring you should look for someone to talk to.

You can see an Elf Lord and a pedestal (on which are an old sword and a mithril shirt) here.

It is now 9:23 am. Wait until 12:00 am, though.

>go to rivendell
Rivendell
At the edge of a narrow gorge, the peaceful elven town of Rivendell seems almost to sit on the river Bruinen. Wherever you are you can hear water streaming by or roaring down steep cliffs. Maybe before exploring you should look for someone to talk to.

You can see an Elf Lord and a pedestal (on which are an old sword and a mithril shirt) here.

It is now 9:24 am. Wait until 12:00 am, though.

>x
What do you want to examine?

>council
You can't see any such thing.

>z
Time passes.

It is now 9:25 am. Wait until 12:00 am, though.

>z
Time passes.

It is now 9:26 am. Wait until 12:00 am, though.

>ask
What do you want to ask?

>ask gandalf
You can't see any such thing.

>go to shire
Shire
Round, colorful doors are set in the sprawling green hills, from the tops of which the smoke of small chimneys hints at homely meals shared at round tables. Some hobbits are venturing the paths between smials, others are enjoying the sun. Gandalf towers above all even while sitting on his favorite chair. You can see Sam & Pip lounging on the grass.

>ask
What do you want to ask?

>about
You can't see any such thing.

>speak
I didn't understand that sentence.

>s
You can't go that way.

>dialoguer
That's not a verb I recognize.

>who
That's not a verb I recognize.

>talk to
Whom do you want to talk to?

>gandalf
To start a conversation, you need to use ASK Gandalf ABOUT something. Type "ask Gandalf (about)" to see the available's topic.

>ask gandalf about
 You could ask Gandalf about you.

>ASK Gandalf ABOUT something.
I d'ont see what you mean, sorry.

>ask gandalf
 You could ask Gandalf about you.

>talk to sam
To start a conversation, you need to use ASK Sam & Pip ABOUT something. Type "ask Sam & Pip (about)" to see the available's topic.

>"ask Gandalf (about)"
That's not a verb I recognize.

>ask Gandalf (about)
I only understood you as far as wanting to ask Gandalf.

>ask gandalf about
 You could ask Gandalf about you.

>ask gandalf about me
"Sire, who I am ?"... Did you smoke something? Are you alright? Is this some sort of test? You are Frodo Baggins, of course, hobbit of the Shire.

Now you could also ask Gandalf about him, the weather, or life.

>ask Gandalf about him
I am Gandalf the Grey. I was sent to Middle Earth to help destroy the ring that you now hold. I am an Istar , a wizard of old.

>ask gandalf about ring
I d'ont see what you mean, sorry.

>go to Rivendell
Rivendell
At the edge of a narrow gorge, the peaceful elven town of Rivendell seems almost to sit on the river Bruinen. Wherever you are you can hear water streaming by or roaring down steep cliffs. Maybe before exploring you should look for someone to talk to.

You can see an Elf Lord and a pedestal (on which are an old sword and a mithril shirt) here.

It is now 9:36 am. Wait until 6:41 am, though.

>z
Time passes.

It is now 9:37 am. Wait until 6:41 am, though.

>search
What do you want to search?

>person
You can't see any such thing.

>people
That's not a verb I recognize.

>take
What do you want to take?

>sword
Taken.

It is now 9:38 am. Wait until 6:41 am, though.

>take
What do you want to take?

>mithril
Taken.

It is now 9:39 am. Wait until 6:41 am, though.

>i
You are carrying:
  a mithril shirt
  an old sword
  a bag of money
  a pipe
  a Ring

It is now 9:40 am. Wait until 6:41 am, though.

>z
Time passes.

It is now 9:41 am. Wait until 6:41 am, though.

>go to rivendell
Rivendell
At the edge of a narrow gorge, the peaceful elven town of Rivendell seems almost to sit on the river Bruinen. Wherever you are you can hear water streaming by or roaring down steep cliffs. Maybe before exploring you should look for someone to talk to.

You can see an Elf Lord and a pedestal here.

It is now 9:42 am. Wait until 6:41 am, though.

>z
Time passes.

It is now 9:43 am. Wait until 6:41 am, though.

>z
Time passes.

It is now 9:44 am. Wait until 6:41 am, though.

>z
Time passes.

It is now 9:45 am. Wait until 6:41 am, though.

>z
Time passes.

It is now 9:46 am. Wait until 6:41 am, though.

>z
Time passes.

It is now 9:47 am. Wait until 6:41 am, though.

>z
Time passes.

It is now 9:48 am. Wait until 6:41 am, though.

>z
Time passes.

It is now 9:49 am. Wait until 6:41 am, though.

>z
Time passes.

It is now 9:50 am. Wait until 6:41 am, though.

>z
Time passes.

It is now 9:51 am. Wait until 6:41 am, though.

>z
Time passes.

It is now 9:52 am. Wait until 6:41 am, though.

>z
Time passes.

It is now 9:53 am. Wait until 6:41 am, though.

>z
Time passes.

It is now 9:54 am. Wait until 6:41 am, though.

>z
Time passes.

It is now 9:55 am. Wait until 6:41 am, though.

>z
Time passes.

It is now 9:56 am. Wait until 6:41 am, though.

>z
Time passes.

It is now 9:57 am. Wait until 6:41 am, though.

>z
Time passes.

It is now 9:58 am. Wait until 6:41 am, though.

>z
Time passes.

It is now 9:59 am. Wait until 6:41 am, though.

>z
Time passes.

It is now 10:00 am. Wait until 6:41 am, though.

>z
Time passes.

It is now 10:01 am. Wait until 6:41 am, though.

>z
Time passes.

It is now 10:02 am. Wait until 6:41 am, though.

>z
Time passes.

It is now 10:03 am. Wait until 6:41 am, though.

>z
Time passes.

It is now 10:04 am. Wait until 6:41 am, though.

>z
Time passes.

It is now 10:05 am. Wait until 6:41 am, though.

>z
Time passes.

It is now 10:06 am. Wait until 6:41 am, though.

>z
Time passes.

It is now 10:07 am. Wait until 6:41 am, though.

>zz
That's not a verb I recognize.

I beg your pardon?

>z
Time passes.

It is now 10:08 am. Wait until 6:41 am, though.

>z
Time passes.

It is now 10:09 am. Wait until 6:41 am, though.

>z
Time passes.

It is now 10:10 am. Wait until 6:41 am, though.

>z
Time passes.

It is now 10:11 am. Wait until 6:41 am, though.

>z
Time passes.

It is now 10:12 am. Wait until 6:41 am, though.

>z
Time passes.

It is now 10:13 am. Wait until 6:41 am, though.

>z
Time passes.

It is now 10:14 am. Wait until 6:41 am, though.

>z
Time passes.

It is now 10:15 am. Wait until 6:41 am, though.

>z
Time passes.

It is now 10:16 am. Wait until 6:41 am, though.

>z
Time passes.

It is now 10:17 am. Wait until 6:41 am, though.

>z
Time passes.

It is now 10:18 am. Wait until 6:41 am, though.

>z
Time passes.

It is now 10:19 am. Wait until 6:41 am, though.

>z
Time passes.

It is now 10:20 am. Wait until 6:41 am, though.

>z
Time passes.

It is now 10:21 am. Wait until 6:41 am, though.

>z
Time passes.

It is now 10:22 am. Wait until 6:41 am, though.

>z
Time passes.

It is now 10:23 am. Wait until 6:41 am, though.

>z
Time passes.

It is now 10:24 am. Wait until 6:41 am, though.

>z
Time passes.

It is now 10:25 am. Wait until 6:41 am, though.

>z
Time passes.

It is now 10:26 am. Wait until 6:41 am, though.

>z
Time passes.

It is now 10:27 am. Wait until 6:41 am, though.

>z
Time passes.

It is now 10:28 am. Wait until 6:41 am, though.

>z
Time passes.

It is now 10:29 am. Wait until 6:41 am, though.

>z
Time passes.

It is now 10:30 am. Wait until 6:41 am, though.

>z
Time passes.

It is now 10:31 am. Wait until 6:41 am, though.

>z
Time passes.

It is now 10:32 am. Wait until 6:41 am, though.

>z
Time passes.

It is now 10:33 am. Wait until 6:41 am, though.

>z
Time passes.

It is now 10:34 am. Wait until 6:41 am, though.

>z
Time passes.

It is now 10:35 am. Wait until 6:41 am, though.

>z
Time passes.

It is now 10:36 am. Wait until 6:41 am, though.

>z
Time passes.

It is now 10:37 am. Wait until 6:41 am, though.

>z
Time passes.

It is now 10:38 am. Wait until 6:41 am, though.

>z
Time passes.

It is now 10:39 am. Wait until 6:41 am, though.

>z
Time passes.

It is now 10:40 am. Wait until 6:41 am, though.

>z
Time passes.

It is now 10:41 am. Wait until 6:41 am, though.

>z
Time passes.

It is now 10:42 am. Wait until 6:41 am, though.

>z
Time passes.

It is now 10:43 am. Wait until 6:41 am, though.

>z
Time passes.

It is now 10:44 am. Wait until 6:41 am, though.

>z
Time passes.

It is now 10:45 am. Wait until 6:41 am, though.

>z
Time passes.

It is now 10:46 am. Wait until 6:41 am, though.

>z
Time passes.

It is now 10:47 am. Wait until 6:41 am, though.

>z
Time passes.

It is now 10:48 am. Wait until 6:41 am, though.

>z
Time passes.

It is now 10:49 am. Wait until 6:41 am, though.

>z
Time passes.

It is now 10:50 am. Wait until 6:41 am, though.

>z
Time passes.

It is now 10:51 am. Wait until 6:41 am, though.

>z
Time passes.

It is now 10:52 am. Wait until 6:41 am, though.

>z
Time passes.

It is now 10:53 am. Wait until 6:41 am, though.

>z
Time passes.

It is now 10:54 am. Wait until 6:41 am, though.

>z
Time passes.

It is now 10:55 am. Wait until 6:41 am, though.

>z
Time passes.

It is now 10:56 am. Wait until 6:41 am, though.

>z
Time passes.

It is now 10:57 am. Wait until 6:41 am, though.

>z
Time passes.

It is now 10:58 am. Wait until 6:41 am, though.

>z
Time passes.

It is now 10:59 am. Wait until 6:41 am, though.

>z
Time passes.

It is now 11:00 am. Wait until 6:41 am, though.

>z
Time passes.

It is now 11:01 am. Wait until 6:41 am, though.

>z
Time passes.

It is now 11:02 am. Wait until 6:41 am, though.

>z
Time passes.

It is now 11:03 am. Wait until 6:41 am, though.

>z
Time passes.

It is now 11:04 am. Wait until 6:41 am, though.

>z
Time passes.

It is now 11:05 am. Wait until 6:41 am, though.

>z
Time passes.

It is now 11:06 am. Wait until 6:41 am, though.

>z
Time passes.

It is now 11:07 am. Wait until 6:41 am, though.

>z
Time passes.

It is now 11:08 am. Wait until 6:41 am, though.

>z
Time passes.

It is now 11:09 am. Wait until 6:41 am, though.

>z
Time passes.

It is now 11:10 am. Wait until 6:41 am, though.

>z
Time passes.

It is now 11:11 am. Wait until 6:41 am, though.

>z
Time passes.

It is now 11:12 am. Wait until 6:41 am, though.

>z
Time passes.

It is now 11:13 am. Wait until 6:41 am, though.

>z
Time passes.

It is now 11:14 am. Wait until 6:41 am, though.

>z
Time passes.

It is now 11:15 am. Wait until 6:41 am, though.

>z
Time passes.

It is now 11:16 am. Wait until 6:41 am, though.

>z
Time passes.

It is now 11:17 am. Wait until 6:41 am, though.

>z
Time passes.

It is now 11:18 am. Wait until 6:41 am, though.

>z
Time passes.

It is now 11:19 am. Wait until 6:41 am, though.

>z
Time passes.

It is now 11:20 am. Wait until 6:41 am, though.

>z
Time passes.

It is now 11:21 am. Wait until 6:41 am, though.

>z
Time passes.

It is now 11:22 am. Wait until 6:41 am, though.

>z
Time passes.

It is now 11:23 am. Wait until 6:41 am, though.

>z
Time passes.

It is now 11:24 am. Wait until 6:41 am, though.

>z
Time passes.

It is now 11:25 am. Wait until 6:41 am, though.

>z
Time passes.

It is now 11:26 am. Wait until 6:41 am, though.

>z
Time passes.

It is now 11:27 am. Wait until 6:41 am, though.

>z
Time passes.

It is now 11:28 am. Wait until 6:41 am, though.

>z
Time passes.

It is now 11:29 am. Wait until 6:41 am, though.

>z
Time passes.

It is now 11:30 am. Wait until 6:41 am, though.

>z
Time passes.

It is now 11:31 am. Wait until 6:41 am, though.

>z
Time passes.

It is now 11:32 am. Wait until 6:41 am, though.

>z
Time passes.

It is now 11:33 am. Wait until 6:41 am, though.

>z
Time passes.

It is now 11:34 am. Wait until 6:41 am, though.

>z
Time passes.

It is now 11:35 am. Wait until 6:41 am, though.

>z
Time passes.

It is now 11:36 am. Wait until 6:41 am, though.

>z
Time passes.

It is now 11:37 am. Wait until 6:41 am, though.

>z
Time passes.

It is now 11:38 am. Wait until 6:41 am, though.

>z
Time passes.

It is now 11:39 am. Wait until 6:41 am, though.

>z
Time passes.

It is now 11:40 am. Wait until 6:41 am, though.

>z
Time passes.

It is now 11:41 am. Wait until 6:41 am, though.

>z
Time passes.

It is now 11:42 am. Wait until 6:41 am, though.

>z
Time passes.

It is now 11:43 am. Wait until 6:41 am, though.

>z
Time passes.

It is now 11:44 am. Wait until 6:41 am, though.

>z
Time passes.

It is now 11:45 am. Wait until 6:41 am, though.

>z
Time passes.

It is now 11:46 am. Wait until 6:41 am, though.

>z
Time passes.

It is now 11:47 am. Wait until 6:41 am, though.

>wait
Time passes.

It is now 11:48 am. Wait until 6:41 am, though.

* * *

>put ring on
You have a bad feeling about this ring. Are you really sure you want to do that?

>y
You slowly put the ring on your finger, wary of the bad feeling.

This feels weird, you feel weird…your vision isn't the same, what happened?! You lift your hand in front of your eyes but…you can see through it! Are you invisible?!

>take ring off
Do you really want to let go of all this power that is surging in you? You feel so good and so strong right now.

>y
After removing the ring, you feel like you've escaped great danger.

>put ring on
You have a bad feeling about this ring. Are you really sure you want to do that?

>y
You slowly put the ring on your finger, wary of the bad feeling.

This feels weird, you feel weird…your vision isn't the same, what happened?! You lift your hand in front of your eyes but…you can see through it! Are you invisible?!

You feel the Great Eye following you.

>take ring off
Do you really want to let go of all this power that is surging in you? You feel so good and so strong right now.

* * *

>y
You slowly put the ring on your finger, wary of the bad feeling.

This feels weird, you feel weird…your vision isn't the same, what happened?! You lift your hand in front of your eyes but…you can see through it! Are you invisible?!

You feel the Great Eye following you.

>go outside
Shire
Round, colorful doors are set in the sprawling green hills, from the tops of which the smoke of small chimneys hints at homely meals shared at round tables. Some hobbits are venturing the paths between smials, others are enjoying the sun. Gandalf towers above all even while sitting on his favorite chair. You can see Sam & Pip lounging on the grass.

You see a nazgul on the back of a dragon rushing towards you. No time to escape, he picks you up in his claws.
You wanted to go to Mordor, right? Well, you're there. But yeah, the plan was not to give the ring to Sauron so that he may rule all of Middle Earth, but you already knew that didn't you?

    *** 

GAME OVER

Your greed for power was your downfall. There is probably an important life lesson to learn here about but who are we to judge. We wish to thank you in any case for having played, it has been fun (for us at least).

All the best to you, dear player, and if you want to try again, just remember to not let the bad guy win. Good luck! ***

Would you like to RESTART, RESTORE a saved game, QUIT, or UNDO the last command?

* * *

>talk to sam
You can't see any such thing.

>ask sam about him
You can't see any such thing.

>go outside
Shire
Round, colorful doors are set in the sprawling green hills, from the tops of which the smoke of small chimneys hints at homely meals shared at round tables. Some hobbits are venturing the paths between smials, others are enjoying the sun. Gandalf towers above all even while sitting on his favorite chair. You can see Sam & Pip lounging on the grass.

* * *

>ask sam about them
Frodo did you hit your head? I'm Sam, that's Pip, we have been friends for ages.

Now you could also ask Sam & Pip about pipe-weed or the quest.

>ask sam about pipe-weed
"Well…we stole, I mean borrowed! We borrowed some from old Dinodas while he was drunk. Would you like some?"
Sam & Pip give you some nice pipe-weed.

>i
You are carrying:
  Pipe-weed
  a Ring

>go inside
Bag End
You find yourself in a cavernicolous and airy room. Doors, windows and ceilings are round, like if someone has carved holes in the earth itself. Outside you can hear the laughter of children and the chirping of birds.

You can see a little table (on which are a green book and a map), a trunk (closed), a cupboard (closed), and a cushy armchair here.

>open trunk
You open the trunk, revealing a pipe and a bag of money.

* * *

>take pipe
Taken.

>smoke weed
You light Pipe-weed with your lighter and inhale deeply. You can almost feel the air moving inside your lungs, Pipe-weed sinking deep in your blood and your brain. Life is such a strange and wonderous thing and what matters if you're stuck inside a version of Lord of the Rings where everyone treats you like an idiot? You know how this story begins and ends, if you could just turn to one of the last chapters, you could show them, show them all how the story of Frodo Baggins should have gone. You can see the pages in your mind, you turn and turn and turn them…and you find yourself teleported to Mount Doom!

Mount Doom
The heat is blistering, suffocating. Somewhere belove you licks of flame run along barren rock and molten lava churns at the mouth of the active volcano.  The ring hisses, dark things, promises of power and greed, it would even implore and beg if it was capable of such a thing. This could be the end of your story, the end of your adventure, will there be ships to whisk you away once you throw the ring to the flames of Mount Doom?

You can see a volcano (empty) here.

>throw ring in the volcano
The ring fights you; it thrashes in your fingers, it implores, in its whispered hisses, but you manage to throw it into the lava. You see it slowly melt away in the fires of the volcano. A great weight seems to have lifted from your shoulders.

    *** Despite the blistering and suffocating heat a great wind suddenly picks up. You know this feeling of being pulled in different directions, your hair flipping wildly about. 

WOOOOOSH

You find yourself in the old room, the beautiful paintings are still there, as is the book, now closed and resting, unassuming, on the table. One thing is different, though, one thing has changed. There is a door now, a simple wooden door that you open with almost giddy satisfaction. As soon as you are outside you breathe a sigh of relief.
Isn't this library just beautiful? You came in here looking for your favorite book and you somehow got lost in between the racks. There was a…door? You turn around but all you see is a blank wall and nothing more. Mmh…something at the back of your mind whispers of a great adventure…something, with a book...and smoking? You really cannot remember now. Well, it must not be that important. It's time to get something to eat anyway. You leave, never looking back, but feeling somewhat satisfied with yourself. ***

Would you like to RESTART, RESTORE a saved game, QUIT, or UNDO the last command?

* * *

Lord of the Read
An Interactive Fiction by Simon, Tessa and Marcela
Release 1 / Serial number 210604 / Inform 7 build 6M62 (I6/v6.34 lib 6/12N) SD

Old room
Something here calls to you, like a whisper in the wind or the faint rustling of the worn pages of a well-loved book. Around and above you the walls are covered in paint. You can't seem to remember how you made it here. There are no doors, no way for you to get out, not even a window to suggest where in the world you are.

You can see an old table (on which is a mysterious book) here.

>read
(the old table)
You can't read that.

>read book
Holding your breath, you carefully open the book.

"...One Ring to rule them all, One Ring to find them,
One Ring to bring them all and in the darkness bind them.
In the Land of Mordor where the Shadows lie..."

You can barely make out a few sentences before words and letters begin to move in concentric swirls. You try to take a step back, but your fingers are stuck to the pages.
WOOOOOSH
 A great wind pulls at you and the only thing you can do is scream and scream in terror. You look one last time at the beautiful paintings on the walls and then everything goes black.  
 

Bag End
You find yourself in a cavernicolous and airy room. Doors, windows and ceilings are round, like if someone has carved holes in the earth itself. Outside you can hear the laughter of children and the chirping of birds.

You can see a little table (on which are a green book and a map), a trunk (closed), and a cupboard here.

>go outside
Shire
Round, colorful doors are set in the sprawling green hills, from the tops of which the smoke of small chimneys hints at homely meals shared at round tables. Some hobbits are venturing the paths between smials, others are enjoying the sun. Gandalf towers above all even while sitting on his favorite chair. You can see Sam & Pip lounging on the grass.

>i
You are carrying:
  a Ring

>throw the ring into lava
You can't see any such thing.

>throw the ring into the lava
You can't see any such thing.

>i
You are carrying:
  a Ring

>throw the ring into gandalf
He can't contain things.

>go inside
Bag End
You find yourself in a cavernicolous and airy room. Doors, windows and ceilings are round, like if someone has carved holes in the earth itself. Outside you can hear the laughter of children and the chirping of birds.

You can see a little table (on which are a green book and a map), a trunk (closed), and a cupboard here.

>throw the ring into the table
That can't contain things.

>throw the ring into the trunk
The trunk is closed.

>open trunk
You open the trunk, revealing a pipe and a bag of money.

>throw the ring into the trunk
You put the Ring into the trunk.

>take the ring
Taken.

>go to mount doom
Mount Doom
The heat is blistering, suffocating. Somewhere belove you licks of flame run along barren rock and molten lava churns at the mouth of the active volcano.  The ring hisses, dark things, promises of power and greed, it would even implore and beg if it was capable of such a thing.  
 This could be the end of your story, the end of your adventure, will there be ships to whisk you away once you throw the ring to the flames of Mount Doom?

You can see a volcano (empty) here.

>throw the ring into the volcano
You throw the ring in the voclano tada !

    *** You have reached an impasse, a stalemate ***

Would you like to RESTART, RESTORE a saved game, QUIT, or UNDO the last command?

>i
Please give one of the answers above.

Would you like to RESTART, RESTORE a saved game, QUIT, or UNDO the last command?

>i
Please give one of the answers above.

Would you like to RESTART, RESTORE a saved game, QUIT, or UNDO the last command?

>go to the shire
Please give one of the answers above.

Would you like to RESTART, RESTORE a saved game, QUIT, or UNDO the last command?

>go inside
Please give one of the answers above.

Would you like to RESTART, RESTORE a saved game, QUIT, or UNDO the last command?

>take the map
Please give one of the answers above.

Would you like to RESTART, RESTORE a saved game, QUIT, or UNDO the last command?

>take the pipe
Please give one of the answers above.

Would you like to RESTART, RESTORE a saved game, QUIT, or UNDO the last command?

>go to mount doom
Please give one of the answers above.

Would you like to RESTART, RESTORE a saved game, QUIT, or UNDO the last command?

>throw the map
Please give one of the answers above.

Would you like to RESTART, RESTORE a saved game, QUIT, or UNDO the last command?

>throw the map into the volcano
Please give one of the answers above.

Would you like to RESTART, RESTORE a saved game, QUIT, or UNDO the last command?

>i
Please give one of the answers above.

Would you like to RESTART, RESTORE a saved game, QUIT, or UNDO the last command?

* * *

Lord of the Read
An Interactive Fiction by Simon, Tessa and Marcela
Release 1 / Serial number 210604 / Inform 7 build 6M62 (I6/v6.34 lib 6/12N) SD

Old room
Something here calls to you, like a whisper in the wind or the faint rustling of the worn pages of a well-loved book. Around and above you the walls are covered in paint. You can't seem to remember how you made it here. There are no doors, no way for you to get out, not even a window to suggest where in the world you are.

You can see an old table (on which is a mysterious book) here.

>read book
Holding your breath, you carefully open the book.

"...One Ring to rule them all, One Ring to find them,
One Ring to bring them all and in the darkness bind them.
In the Land of Mordor where the Shadows lie..."

You can barely make out a few sentences before words and letters begin to move in concentric swirls. You try to take a step back, but your fingers are stuck to the pages.
WOOOOOSH
 A great wind pulls at you and the only thing you can do is scream and scream in terror. You look one last time at the beautiful paintings on the walls and then everything goes black.

Bag End
You find yourself in a cavernicolous and airy room. Doors, windows and ceilings are round, like if someone has carved holes in the earth itself. Outside you can hear the laughter of children and the chirping of birds.

You can see a little table (on which are a green book and a map), a trunk (closed), a cupboard (closed), and a cushy armchair here.

>e
You can't go that way.

>w
You can't go that way.

>s
You can't go that way.

>n
You can't go that way.

(You heard some noise OUTSIDE, you maybe can try to go there?)

>d
You can't go that way.

>u
You can't go that way.

>in
You can't go that way.

>out
Shire
Round, colorful doors are set in the sprawling green hills, from the tops of which the smoke of small chimneys hints at homely meals shared at round tables. Some hobbits are venturing the paths between smials, others are enjoying the sun. Gandalf towers above all even while sitting on his favorite chair. You can see Sam & Pip lounging on the grass.

>e
This is the way for Rivendell, but history doesn't want you to go into the woods alone, sorry.

>e
This is the way for Rivendell, but history doesn't want you to go into the woods alone, sorry.

>w
You can't go that way.

>w
You can't go that way.

>ask gandalf about him
I d'ont see what you mean, sorry.

>ask gandalf about you
"Sir, who I am?"... Did you smoke something? Are you alright? Is this some sort of test? You are Frodo Baggins, of course, hobbit of the Shire.

Now you could also ask about him, the weather, or life.

>ask gandalf about him
I am Gandalf the Grey. I was sent to Middle Earth to help destroy the ring that you now hold. I am an Istar, a wizard of old.

>z
Time passes.

>n
You can't go that way.

>n
You can't go that way.

>n
You can't go that way.

(If you are feeling lost, you maybe need a map... or a book ?! )

>n
You can't go that way.

>inside
Bag End
You find yourself in a cavernicolous and airy room. Doors, windows and ceilings are round, like if someone has carved holes in the earth itself. Outside you can hear the laughter of children and the chirping of birds.

You can see a little table (on which are a green book and a map), a trunk (closed), a cupboard (closed), and a cushy armchair here.

>out
Shire
Round, colorful doors are set in the sprawling green hills, from the tops of which the smoke of small chimneys hints at homely meals shared at round tables. Some hobbits are venturing the paths between smials, others are enjoying the sun. Gandalf towers above all even while sitting on his favorite chair. You can see Sam & Pip lounging on the grass.

>ask sam about him
Frodo did you hit your head? I'm Sam, that's Pip, we have been friends for ages.

Now you could also ask about pipe-weed or the quest.

>ask sam about weed
"Well…we stole, I mean borrowed! We borrowed some from old Dinodas while he was drunk. Would you like some?"

Sam & Pip give you some nice pipe-weed.

>w
You can't go that way.

>w
You can't go that way.

(If you are feeling lost, you maybe need a map... or a book ?! Maybe just chilling is better after all. )

* * *

>go outside
Shire
Round, colorful doors are set in the sprawling green hills, from the tops of which the smoke of small chimneys hints at homely meals shared at round tables. Some hobbits are venturing the paths between smials, others are enjoying the sun. Gandalf towers above all even while sitting on his favorite chair. You can see Sam & Pip lounging on the grass.

>ask gandalf about
 You could ask Gandalf about you.

>w
You can't go that way.

>e
This is the way for Rivendell, but history doesn't want you to go into the woods alone, sorry.

>ask gandalf about me
"Sir, who I am?"... Did you smoke something? Are you alright? Is this some sort of test? You are Frodo Baggins, of course, hobbit of the Shire.

Now you could also ask about him, the weather, or life.

* * *

>ask gandalf about life
You shall not distract yourself with nonsensical and philosophical questions. If you are here to waste my time, go read a book.

Now you could also ask about books, pipe-weed, or the quest.

I beg your pardon?

>ask gandalf about the quest
A great adventure that will take you to places unknown. A long time ago the ring you now hold was created by Sauron, a great evil, to rule over Middle Earth. After a bloody war the ring was cut from its master's hand and lost to the ages. Somehow your uncle Bilbo found it and passed it on to you Frodo. You are the one, the chosen, he who must go to Mount Doom and destroy the ring once and for all. Before the world is plunged in darkness.

Now you could also ask about the ring or Mount Doom.

>ask gandalf about mount doom
The great volcano lies south of here, beyond the mountains. It is the only place where the ring may be vanquished, the final destination to your adventure. I could accompany you there… may I suggest we use the Eagles? They are great beasts and should take us to Mount Doom in no time at all. Would you like to leave right now?

>y
An easy shortcut! How lucky you are!
 You mount on a beautiful Eagle and soon you find yourself flying above the green Shire. Is that really Sam down there, he looks so little, so small, maybe a little too miniscule. Are we sure we are safe flying so high? DON'T LOOK DOWN, DON'T…

It looks like you are too weak for this mode of transportation, we should stop before you throw up on yourself and the Eagle (she might eat you, they really like to keep themselves clean).
You are now in Rivendell...

Rivendell
At the edge of a narrow gorge, the peaceful elven town of Rivendell seems almost to sit on the river Bruinen. Wherever you are you can hear water streaming by or roaring down steep cliffs. Maybe before exploring you should look for someone to talk to.

You can see an Elf Lord and a pedestal (on which are an old sword and a mithril shirt) here.

The Elf Council is in session now. You should hear from them soon.

Gandalf is following you.

>z
Time passes.

>z
Time passes.

A tall lady elf, her hands crossed behind her back, approaches you slowly. Her long dress swishes on the marble pavements. "I am Lady Amarië, messenger to the Elf Council. Your plea for help in your quest has been discussed at long in the sacred halls of the council, the task of the destruction of the ring is one of great importance to all of Middle-Earth. That said, you are an incredibly weak hobbit Frodo Baggins and we do not think that you will be able to make it to Mount Doom and destroy the ring before Sauron finds you. You are unworthy, we will not help. In a few hundred years, maybe, a brave hobbit will be born to your line, one who will withstand the journey and its perils. In the meantime I advise you to go back to the Shire (west) and enjoy a quiet and peaceful life." She turns around and slowly walks away. You would say something but you're pretty sure your jaw has hit the floor at some point.

>w
Shire
Round, colorful doors are set in the sprawling green hills, from the tops of which the smoke of small chimneys hints at homely meals shared at round tables. Some hobbits are venturing the paths between smials, others are enjoying the sun. You can see Sam & Pip lounging on the grass.

Gandalf is following you.

>e
Rivendell
At the edge of a narrow gorge, the peaceful elven town of Rivendell seems almost to sit on the river Bruinen. Wherever you are you can hear water streaming by or roaring down steep cliffs. Maybe before exploring you should look for someone to talk to.

You can see an Elf Lord and a pedestal (on which are an old sword and a mithril shirt) here.

Gandalf is following you.

>w
Shire
Round, colorful doors are set in the sprawling green hills, from the tops of which the smoke of small chimneys hints at homely meals shared at round tables. Some hobbits are venturing the paths between smials, others are enjoying the sun. You can see Sam & Pip lounging on the grass.

Gandalf is following you.

>ask sam about them
Frodo did you hit your head? I'm Sam, that's Pip, we have been friends for ages.

Now you could also ask about pipe-weed or the quest.

* * *

>ask sam about the quest
"Oh, you mean the ring? The one that you should destroy? That is some serious business Pip, don't you think?"
 "Very serious, Sam…"
. "Well, I guess as your friends we should accompany and make sure you don't get eaten by an orc."
 "We are such good friends…where should we start Sam?"
 "Maybe with the Elves? I think Rivendell lies east of here, should we go there Frodo? I think they could help."

>y
The road is long, but Sam & Pip are good company. You share every meal, sing the songs of the Shire when you feel too tired to think and, in the end, you make your way to the elf's city of Rivendell, where the Elf Council is deliberating on if and how much to help you in your quest.

>w
You can't go that way.

>e
Rivendell
At the edge of a narrow gorge, the peaceful elven town of Rivendell seems almost to sit on the river Bruinen. Wherever you are you can hear water streaming by or roaring down steep cliffs. Maybe before exploring you should look for someone to talk to.

You can see an Elf Lord and a pedestal (on which are an old sword and a mithril shirt) here.

Gandalf and Sam & Pip are following you.

>ask gandalf about
 You could ask Gandalf about him, the weather, books, pipe-weed, the ring, me, Rivendell
, Mildred, or the quest.

>ask sam about
 You could ask Sam & Pip about pipe-weed, Rivendell, Elf Council, the ring, or pipe-weed.

* * *

>ask gandalf about the quest
A great adventure that will take you to places unknown. A long time ago the ring you now hold was created by Sauron, a great evil, to rule over Middle Earth. After a bloody war the ring was cut from its master's hand and lost to the ages. Somehow your uncle Bilbo found it and passed it on to you Frodo. You are the one, the chosen, he who must go to Mount Doom and destroy the ring once and for all. Before the world is plunged in darkness.

Now you could also ask about the ring or Mount Doom.

>ask gandalf about Mount doom
The great volcano lies south of here, beyond the mountains. It is the only place where the ring may be vanquished, the final destination to your adventure. I could accompany you there… may I suggest we use the Eagles? They are great beasts and should take us to Mount Doom in no time at all. Would you like to leave right now?

>y
An easy shortcut! How lucky you are!
 You mount on a beautiful Eagle and soon you find yourself flying above the green Shire. Is that really Sam down there, he looks so little, so small, maybe a little too miniscule. Are we sure we are safe flying so high? DON'T LOOK DOWN, DON'T…

It looks like you are too weak for this mode of transportation, we should stop before you throw up on yourself and the Eagle (she might eat you, they really like to keep themselves clean).
You are now in Rivendell...

Rivendell
At the edge of a narrow gorge, the peaceful elven town of Rivendell seems almost to sit on the river Bruinen. Wherever you are you can hear water streaming by or roaring down steep cliffs. Maybe before exploring you should look for someone to talk to.

You can see an Elf Lord and a pedestal (on which are an old sword and a mithril shirt) here.

The Elf Council is in session now. You should hear from them soon.

Gandalf is following you.

>d
You can't go that way.

>e
You can't go that way.

>r
That's not a verb I recognize.

>z
Time passes.

A tall lady elf, her hands crossed behind her back, approaches you slowly. Her long dress swishes on the marble pavements. "I am Lady Amarië, messenger to the Elf Council. Your plea for help in your quest has been discussed at long in the sacred halls of the council, the task of the destruction of the ring is one of great importance to all of Middle-Earth. That said, you are an incredibly weak hobbit Frodo Baggins and we do not think that you will be able to make it to Mount Doom and destroy the ring before Sauron finds you. You are unworthy, we will not help. In a few hundred years, maybe, a brave hobbit will be born to your line, one who will withstand the journey and its perils. In the meantime I advise you to go back to the Shire (west) and enjoy a quiet and peaceful life." She turns around and slowly walks away. You would say something but you're pretty sure your jaw has hit the floor at some point.

* * *

>w
Shire
Round, colorful doors are set in the sprawling green hills, from the tops of which the smoke of small chimneys hints at homely meals shared at round tables. Some hobbits are venturing the paths between smials, others are enjoying the sun. You can see Sam & Pip lounging on the grass.

Gandalf is following you.

>ask gandalf
 You could ask Gandalf about him, the weather, books, pipe-weed, the ring, me, Rivendell
, Mildred, or the quest.

>ask sam about them
Frodo did you hit your head? I'm Sam, that's Pip, we have been friends for ages.

Now you could also ask about pipe-weed or the quest.

* * *

>y
The road is long, but Sam & Pip are good company. You share every meal, sing the songs of the Shire when you feel too tired to think and, in the end, you make your way to the elf's city of Rivendell, where the Elf Council is deliberating on if and how much to help you in your quest.

>ask sam about
 You could ask Sam & Pip about pipe-weed.

>w
You can't go that way.

* * *

>go outside
Shire
Round, colorful doors are set in the sprawling green hills, from the tops of which the smoke of small chimneys hints at homely meals shared at round tables. Some hobbits are venturing the paths between smials, others are enjoying the sun. Gandalf towers above all even while sitting on his favorite chair. You can see Sam & Pip lounging on the grass.

>ask sam about
 You could ask Sam & Pip about them.

* * *

>w
You can't go that way.

>e
Rivendell
At the edge of a narrow gorge, the peaceful elven town of Rivendell seems almost to sit on the river Bruinen. Wherever you are you can hear water streaming by or roaring down steep cliffs. Maybe before exploring you should look for someone to talk to.

You can see an Elf Lord and a pedestal (on which are an old sword and a mithril shirt) here.

The Elf Council is in session now. You should hear from them soon.

Sam & Pip is following you.

>ask sam about
 You could ask Sam & Pip about pipe-weed, Rivendell, Elf Council, the ring, or pipe-weed.

>w
You should wait for the Council.

>w
You should wait for the Council.

A tall lady elf, her hands crossed behind her back, approaches you slowly. Her long dress swishes on the marble pavements. "I am Lady Amarië, messenger to the Elf Council. Your plea for help in your quest has been discussed at long in the sacred halls of the council, the task of the destruction of the ring is one of great importance to all of Middle-Earth. That said, you are an incredibly weak hobbit Frodo Baggins and we do not think that you will be able to make it to Mount Doom and destroy the ring before Sauron finds you. You are unworthy, we will not help. In a few hundred years, maybe, a brave hobbit will be born to your line, one who will withstand the journey and its perils. In the meantime I advise you to go back to the Shire (west) and enjoy a quiet and peaceful life." She turns around and slowly walks away. You would say something but you're pretty sure your jaw has hit the floor at some point.

>w
Shire
Round, colorful doors are set in the sprawling green hills, from the tops of which the smoke of small chimneys hints at homely meals shared at round tables. Some hobbits are venturing the paths between smials, others are enjoying the sun. Gandalf towers above all even while sitting on his favorite chair.

Sam & Pip is following you.

>showme sam
Sam & Pip - character
location: in the Shire
singular-named, proper-named; unlit, inedible, portable; male, visible; following
list grouping key: none
printed name: "Sam & Pip"
printed plural name: "characters"
indefinite article: none
description: none
initial appearance: none
carrying capacity: 100
Responses Table: Table of Sam Responses
Seconde Responses Table: Table of Seconde Sam Responses
Answered List: them and the quest
Already Visited Room: Shire and Rivendell

>go inside
Bag End
You find yourself in a cavernicolous and airy room. Doors, windows and ceilings are round, like if someone has carved holes in the earth itself. Outside you can hear the laughter of children and the chirping of birds.

You can see a little table (on which are a green book and a map), a trunk (closed), a cupboard (closed), and a cushy armchair here.

Sam & Pip is following you.

>ask sam
 You could ask Sam & Pip about pipe-weed, Rivendell, Elf Council, the ring, or pipe-weed.

>ask sam about elf council
Last we heard they were still deliberating, but I bet that they will soon be out.

>ask sam
 You could ask Sam & Pip about pipe-weed, Rivendell, the ring, or pipe-weed.

>go outside
Shire
Round, colorful doors are set in the sprawling green hills, from the tops of which the smoke of small chimneys hints at homely meals shared at round tables. Some hobbits are venturing the paths between smials, others are enjoying the sun. Gandalf towers above all even while sitting on his favorite chair.

Sam & Pip is following you.

>ask gandalf about me
"Sir, who I am?"... Did you smoke something? Are you alright? Is this some sort of test? You are Frodo Baggins, of course, hobbit of the Shire.

Now you could also ask about him, the weather, or life.

>ask gandalf about the life
I d'ont see what you mean, sorry.

>ask gandalf about life
You shall not distract yourself with nonsensical and philosophical questions. If you are here to waste my time, go read a book.

Now you could also ask about books, pipe-weed, or the quest.

* * *

>ask gandalf about the quest
A great adventure that will take you to places unknown. A long time ago the ring you now hold was created by Sauron, a great evil, to rule over Middle Earth. After a bloody war the ring was cut from its master's hand and lost to the ages. Somehow your uncle Bilbo found it and passed it on to you Frodo. You are the one, the chosen, he who must go to Mount Doom and destroy the ring once and for all. Before the world is plunged in darkness.

Now you could also ask about the ring or Mount Doom.

>ask gandalf about Mount Doom
The great volcano lies south of here, beyond the mountains. It is the only place where the ring may be vanquished, the final destination to your adventure. I could accompany you there… may I suggest we use the Eagles? They are great beasts and should take us to Mount Doom in no time at all. Would you like to leave right now?

>y
An easy shortcut! How lucky you are!
 You mount on a beautiful Eagle and soon you find yourself flying above the green Shire. Is that really Sam down there, he looks so little, so small, maybe a little too miniscule. Are we sure we are safe flying so high? DON'T LOOK DOWN, DON'T…

It looks like you are too weak for this mode of transportation, we should stop before you throw up on yourself and the Eagle (she might eat you, they really like to keep themselves clean).
You are now in Rivendell...

Rivendell
At the edge of a narrow gorge, the peaceful elven town of Rivendell seems almost to sit on the river Bruinen. Wherever you are you can hear water streaming by or roaring down steep cliffs. Maybe before exploring you should look for someone to talk to.

You can see an Elf Lord and a pedestal (on which are an old sword and a mithril shirt) here.

Gandalf and Sam & Pip are following you.

>ask gandalf
 You could ask Gandalf about him, the weather, books, pipe-weed, the ring, me, Rivendell
, Mildred, or the quest.

>showme gandalf
Gandalf - character
location: in Rivendell
singular-named, proper-named; unlit, inedible, portable; male, visible; following
list grouping key: none
printed name: "Gandalf"
printed plural name: "characters"
indefinite article: none
description: none
initial appearance: none
carrying capacity: 100
Responses Table: Table of Gandalf Responses
Seconde Responses Table: Table of Seconde Gandalf Responses
Answered List: you, life, the quest, and Mount Doom
Already Visited Room: Shire and Rivendell

>showme sam
Sam & Pip - character
location: in Rivendell
singular-named, proper-named; unlit, inedible, portable; male, visible; following
list grouping key: none
printed name: "Sam & Pip"
printed plural name: "characters"
indefinite article: none
description: none
initial appearance: none
carrying capacity: 100
Responses Table: Table of Sam Responses
Seconde Responses Table: Table of Seconde Sam Responses
Answered List: them, the quest, and Elf Council
Already Visited Room: Shire, Rivendell, and Bag End

>w
Shire
Round, colorful doors are set in the sprawling green hills, from the tops of which the smoke of small chimneys hints at homely meals shared at round tables. Some hobbits are venturing the paths between smials, others are enjoying the sun. Your friends must be in some other places at the moment.

Gandalf and Sam & Pip are following you.

* * *

>ask sam about them
Frodo did you hit your head? I'm Sam, that's Pip, we have been friends for ages.

Now you could also ask about pipe-weed or the quest.

>ask same about the quest
You can't see any such thing.

>ask sam about the quest
"Oh, you mean the ring? The one that you should destroy? That is some serious business Pip, don't you think?"
 "Very serious, Sam…"
. "Well, I guess as your friends we should accompany and make sure you don't get eaten by an orc."
 "We are such good friends…where should we start Sam?"
 "Maybe with the Elves? I think Rivendell lies east of here, should we go there Frodo? I think they could help."

* * *

>w
You can't go that way.

>e
Rivendell
At the edge of a narrow gorge, the peaceful elven town of Rivendell seems almost to sit on the river Bruinen. Wherever you are you can hear water streaming by or roaring down steep cliffs. Maybe before exploring you should look for someone to talk to.

You can see an Elf Lord and a pedestal (on which are an old sword and a mithril shirt) here.

The Elf Council is in session now. You should hear from them soon.

Sam & Pip followed you.

>ask sam about the elf council
Last we heard they were still deliberating, but I bet that they will soon be out.

>ask sam about
 You could ask Sam & Pip about pipe-weed, Rivendell, or the ring.

>ask sam about weed
"Well…we stole, I mean borrowed! We borrowed some from old Dinodas while he was drunk. Would you like some?"

Sam & Pip give you some nice pipe-weed.

A tall lady elf, her hands crossed behind her back, approaches you slowly. Her long dress swishes on the marble pavements. "I am Lady Amarië, messenger to the Elf Council. Your plea for help in your quest has been discussed at long in the sacred halls of the council, the task of the destruction of the ring is one of great importance to all of Middle-Earth. That said, you are an incredibly weak hobbit Frodo Baggins and we do not think that you will be able to make it to Mount Doom and destroy the ring before Sauron finds you. You are unworthy, we will not help. In a few hundred years, maybe, a brave hobbit will be born to your line, one who will withstand the journey and its perils. In the meantime I advise you to go back to the Shire (west) and enjoy a quiet and peaceful life." She turns around and slowly walks away. You would say something but you're pretty sure your jaw has hit the floor at some point.

>clue
That's not a verb I recognize.

>list of actions
That's not a verb I recognize.

>talk to sam
To start a conversation, you need to use ASK Sam & Pip ABOUT something. Type "ask Sam & Pip (about)" to see the available topics.

>look
Rivendell
At the edge of a narrow gorge, the peaceful elven town of Rivendell seems almost to sit on the river Bruinen. Wherever you are you can hear water streaming by or roaring down steep cliffs. Maybe before exploring you should look for someone to talk to.

You can see Sam & Pip, an Elf Lord, and a pedestal (on which are an old sword and a mithril shirt) here.

>take pedestal
That's fixed in place.

>help
That's not a verb I recognize.

>h
That's not a verb I recognize.

* * *

>e
Rivendell
At the edge of a narrow gorge, the peaceful elven town of Rivendell seems almost to sit on the river Bruinen. Wherever you are you can hear water streaming by or roaring down steep cliffs. Maybe before exploring you should look for someone to talk to.

You can see an Elf Lord and a pedestal (on which are an old sword and a mithril shirt) here.

The Elf Council is in session now. You should hear from them soon.

Sam & Pip followed you.

>put on the ring
You have a bad feeling about this ring. Are you really sure you want to do that?

>y
You slowly put the ring on your finger, wary of the bad feeling.

This feels weird, you feel weird…your vision isn't the same, what happened?! You lift your hand in front of your eyes but…you can see through it! Are you invisible?!

>w
You should wait for the Council.

>put off the ring
I didn't understand that sentence.

>take off the ring
Do you really want to let go of all this power that is surging in you? You feel so good and so strong right now.

>y
After removing the ring, you feel like you've escaped great danger.

A tall lady elf, her hands crossed behind her back, approaches you slowly. Her long dress swishes on the marble pavements. "I am Lady Amarië, messenger to the Elf Council. Your plea for help in your quest has been discussed at long in the sacred halls of the council, the task of the destruction of the ring is one of great importance to all of Middle-Earth. That said, you are an incredibly weak hobbit Frodo Baggins and we do not think that you will be able to make it to Mount Doom and destroy the ring before Sauron finds you. You are unworthy, we will not help. In a few hundred years, maybe, a brave hobbit will be born to your line, one who will withstand the journey and its perils. In the meantime I advise you to go back to the Shire (west) and enjoy a quiet and peaceful life." She turns around and slowly walks away. You would say something but you're pretty sure your jaw has hit the floor at some point.

>z
Time passes.

>put on the ring
You have a bad feeling about this ring. Are you really sure you want to do that?

* * *

>y
You slowly put the ring on your finger, wary of the bad feeling.

This feels weird, you feel weird…your vision isn't the same, what happened?! You lift your hand in front of your eyes but…you can see through it! Are you invisible?!

>w
Shire
Round, colorful doors are set in the sprawling green hills, from the tops of which the smoke of small chimneys hints at homely meals shared at round tables. Some hobbits are venturing the paths between smials, others are enjoying the sun. Gandalf towers above all even while sitting on his favorite chair.

You look around but no one seems to have followed you anymore.

>ask sam about you
You can't see any such thing.

>ask sam about me
You can't see any such thing.

>i
You are carrying:
  The Ring (being worn)

You feel the Great Eye following you.

>ask sam about pipe-weed
You can't see any such thing.

* * *

>ask sam about them
Frodo did you hit your head? I'm Sam, that's Pip, we have been friends for ages.

Now you could also ask about pipe-weed or the quest.

>ask sam about pipe-weed
"Well…we stole, I mean borrowed! We borrowed some from old Dinodas while he was drunk. Would you like some?"
Sam & Pip give you some nice pipe-weed.

>go inside
Bag End
You find yourself in a cavernicolous and airy room. Doors, windows and ceilings are round, like if someone has carved holes in the earth itself. Outside you can hear the laughter of children and the chirping of birds.

You can see a little table (on which are a green book and a map), a trunk (closed), a cupboard (closed), and a cushy armchair here.

* * *

>take pipe
Taken.

>smoke weed
You light Pipe-weed with your lighter and inhale deeply. You can almost feel the air moving inside your lungs, Pipe-weed sinking deep in your blood and your brain. Life is such a strange and wonderous thing and what matters if you're stuck inside a version of Lord of the Rings where everyone treats you like an idiot? You know how this story begins and ends, if you could just turn to one of the last chapters, you could show them, show them all how the story of Frodo Baggins should have gone. You can see the pages in your mind, you turn and turn and turn them…and you find yourself teleported to Mount Doom!

Mount Doom
The heat is blistering, suffocating. Somewhere below you licks of flames run along barren rock and molten lava churns at the mouth of the active volcano.  The ring hisses, dark things, promises of power and greed, it would even implore and beg if it was capable of such a thing. This could be the end of your story, the end of your adventure, will there be ships to whisk you away once you throw the ring to the flames of Mount Doom?

>throw me in the lava
Unable to throw this powerful ring into the flames, you decide to disappear with it into the magma. Holding the ring in the palm of your hand, you get ready to perform the last dives of your short life. After having gathered all your courage, you are closing your eyes and leting yourself go forward ... But you don't fall.
Turning around, you see that a strange creature has held you back from this deadly fall. Encouraged by this act of kindness emanating from this hostile creature, you rethink about your homeland and your friends... Like that, you decide to get rid of the ring by throwing it into the volcano instead.

>i
You are carrying:
  a pipe
  The Ring

>throw pipe into the lava
You throw the pipe into the lava... you see it burning. A little anticlimactic if you ask me.

>drop ring
Dropped.

>throw me into the lava
What a brave act for a weak creature as you. But you forgot something important didn't you ?

* * *

>ask sam about the quest
"Oh, you mean the ring? The one that you should destroy? That is some serious business Pip, don't you think?"
 "Very serious, Sam…"
. "Well, I guess as your friends we should accompany and make sure you don't get eaten by an orc."
 "We are such good friends…where should we start Sam?"
 "Maybe with the Elves? I think Rivendell lies east of here, should we go there Frodo? I think they could help."

>n
As you please.

>ask sam about
 You could ask Sam & Pip about pipe-weed or the quest.

* * *

>e
Rivendell
At the edge of a narrow gorge, the peaceful elven town of Rivendell seems almost to sit on the river Bruinen. Wherever you are you can hear water streaming by or roaring down steep cliffs. Maybe before exploring you should look for someone to talk to.

You can see an Elf Lord and a pedestal (on which are an old sword and a mithril shirt) here.

The Elf Council is in session now. You should hear from them soon.

Sam & Pip followed you.

>i
You are carrying:
  The Ring

>ask gandalf about him
You can't see any such thing.

>ask gandalf
You can't see any such thing.

>e
You can't go that way.

>w
You should wait for the Council.

A tall lady elf, her hands crossed behind her back, approaches you slowly. Her long dress swishes on the marble pavements. "I am Lady Amarië, messenger to the Elf Council. Your plea for help in your quest has been discussed at long in the sacred halls of the council, the task of the destruction of the ring is one of great importance to all of Middle-Earth. That said, you are an incredibly weak hobbit Frodo Baggins and we do not think that you will be able to make it to Mount Doom and destroy the ring before Sauron finds you. You are unworthy, we will not help. In a few hundred years, maybe, a brave hobbit will be born to your line, one who will withstand the journey and its perils. In the meantime I advise you to go back to the Shire (west) and enjoy a quiet and peaceful life." She turns around and slowly walks away. You would say something but you're pretty sure your jaw has hit the floor at some point.

>w
Shire
Round, colorful doors are set in the sprawling green hills, from the tops of which the smoke of small chimneys hints at homely meals shared at round tables. Some hobbits are venturing the paths between smials, others are enjoying the sun. Gandalf towers above all even while sitting on his favorite chair.

Sam & Pip followed you.

>ask gandlaf
You can't see any such thing.

>ask gandalf
 You could ask Gandalf about you.

>ask gandalf about me
"Sir, who I am?"... Did you smoke something? Are you alright? Is this some sort of test? You are Frodo Baggins, of course, hobbit of the Shire.

Now you could also ask about him, the weather, or life.

* * *

>ask gandalf about the quest
A great adventure that will take you to places unknown. A long time ago the ring you now hold was created by Sauron, a great evil, to rule over Middle Earth. After a bloody war the ring was cut from its master's hand and lost to the ages. Somehow your uncle Bilbo found it and passed it on to you Frodo. You are the one, the chosen, he who must go to Mount Doom and destroy the ring once and for all. Before the world is plunged in darkness.

Now you could also ask about the ring or Mount Doom.

>y
That was a rhetorical question.

>ask gandalf about mount doom
The great volcano lies south of here, beyond the mountains. It is the only place where the ring may be vanquished, the final destination to your adventure. I could accompany you there… may I suggest we use the Eagles? They are great beasts and should take us to Mount Doom in no time at all. Would you like to leave right now?

>y
An easy shortcut! How lucky you are!
 You mount on a beautiful Eagle and soon you find yourself flying above the green Shire. Is that really Sam down there, he looks so little, so small, maybe a little too miniscule. Are we sure we are safe flying so high? DON'T LOOK DOWN, DON'T…

It looks like you are too weak for this mode of transportation, we should stop before you throw up on yourself and the Eagle (she might eat you, they really like to keep themselves clean).
You are now in Rivendell...

Rivendell
At the edge of a narrow gorge, the peaceful elven town of Rivendell seems almost to sit on the river Bruinen. Wherever you are you can hear water streaming by or roaring down steep cliffs. Maybe before exploring you should look for someone to talk to.

You can see an Elf Lord and a pedestal (on which are an old sword and a mithril shirt) here.

Gandalf and Sam & Pip followed you.

>w
Shire
Round, colorful doors are set in the sprawling green hills, from the tops of which the smoke of small chimneys hints at homely meals shared at round tables. Some hobbits are venturing the paths between smials, others are enjoying the sun. Your friends must be in some other places at the moment.

Gandalf and Sam & Pip followed you.

>e
Rivendell
At the edge of a narrow gorge, the peaceful elven town of Rivendell seems almost to sit on the river Bruinen. Wherever you are you can hear water streaming by or roaring down steep cliffs. Maybe before exploring you should look for someone to talk to.

You can see an Elf Lord and a pedestal (on which are an old sword and a mithril shirt) here.

Gandalf and Sam & Pip followed you.

>w
Shire
Round, colorful doors are set in the sprawling green hills, from the tops of which the smoke of small chimneys hints at homely meals shared at round tables. Some hobbits are venturing the paths between smials, others are enjoying the sun. Your friends must be in some other places at the moment.

Gandalf and Sam & Pip followed you.

* * *

>e
Rivendell
At the edge of a narrow gorge, the peaceful elven town of Rivendell seems almost to sit on the river Bruinen. Wherever you are you can hear water streaming by or roaring down steep cliffs. Maybe before exploring you should look for someone to talk to.

You can see an Elf Lord and a pedestal (on which are an old sword and a mithril shirt) here.

Gandalf and Sam & Pip followed you.

>put on the ring
You have a bad feeling about this ring. Are you really sure you want to do that?

* * *

>y
You slowly put the ring on your finger, wary of the bad feeling.

This feels weird, you feel weird…your vision isn't the same, what happened?! You lift your hand in front of your eyes but…you can see through it! Are you invisible?!

>w
Shire
Round, colorful doors are set in the sprawling green hills, from the tops of which the smoke of small chimneys hints at homely meals shared at round tables. Some hobbits are venturing the paths between smials, others are enjoying the sun. Your friends must be in some other places at the moment.

You look around but no one seems to have followed you anymore.

>tke off the ring
That's not a verb I recognize.

>take off the ring
Do you really want to let go of all this power that is surging in you? You feel so good and so strong right now.

* * *

>go outside
Shire
Round, colorful doors are set in the sprawling green hills, from the tops of which the smoke of small chimneys hints at homely meals shared at round tables. Some hobbits are venturing the paths between smials, others are enjoying the sun. Gandalf towers above all even while sitting on his favorite chair. You can see Sam & Pip lounging on the grass.

>e
This is the way for Rivendell, but history doesn't want you to go into the woods alone, sorry.

>ask sam
 You could ask Sam & Pip about them.

>ask sam & Pip about them
Frodo did you hit your head? I'm Sam, that's Pip, we have been friends for ages.

Now you could also ask Sam & Pip about pipe-weed or the quest.

>ask sam & Pip about the quest
"Oh, you mean the ring? The one that you should destroy? That is some serious business Pip, don't you think?"
 "Very serious, Sam…"
. "Well, I guess as your friends we should accompany and make sure you don't get eaten by an orc."
 "We are such good friends…where should we start Sam?"
 "Maybe with the Elves? I think Rivendell lies east of here, should we go there Frodo? I think they could help."

>y
The road is long, but Sam & Pip are good company. You share every meal, sing the songs of the Shire when you feel too tired to think and, in the end, you make your way to the elf's city of Rivendell, where the Elf Council is deliberating on if and how much to help you in your quest.

>e
Rivendell
At the edge of a narrow gorge, the peaceful elven town of Rivendell seems almost to sit on the river Bruinen. Wherever you are you can hear water streaming by or roaring down steep cliffs. Maybe before exploring you should look for someone to talk to.

You can see an Elf Lord and a pedestal (on which are an old sword and a mithril shirt) here.

The Elf Council is in session now. You should hear from them soon.

Sam & Pip are following you.

>ask sam about
 You could ask Sam & Pip about pipe-weed, Rivendell, Elf Council, the ring, or pipe-weed.

>ask sam about
 You could ask Sam & Pip about pipe-weed, Rivendell, Elf Council, the ring, or pipe-weed.

>showme sam
Sam & Pip - character
location: in Rivendell
singular-named, proper-named; unlit, inedible, portable; male, visible; following
list grouping key: none
printed name: "Sam & Pip"
printed plural name: "characters"
indefinite article: none
description: none
initial appearance: none
carrying capacity: 100
Responses Table: Table of Sam Responses
Seconde Responses Table: Table of Seconde Sam Responses
Answered List: them and the quest

>z
Time passes.

A tall lady elf, her hands crossed behind her back, approaches you slowly. Her long dress swishes on the marble pavements. "I am Lady Amarië, messenger to the Elf Council. Your plea for help in your quest has been discussed at long in the sacred halls of the council, the task of the destruction of the ring is one of great importance to all of Middle-Earth. That said, you are an incredibly weak hobbit Frodo Baggins and we do not think that you will be able to make it to Mount Doom and destroy the ring before Sauron finds you. You are unworthy, we will not help. In a few hundred years, maybe, a brave hobbit will be born to your line, one who will withstand the journey and its perils. In the meantime I advise you to go back to the Shire (west) and enjoy a quiet and peaceful life." She turns around and slowly walks away. You would say something but you're pretty sure your jaw has hit the floor at some point.

>go to mount doom
Mount Doom
The heat is blistering, suffocating. Somewhere belove you licks of flame run along barren rock and molten lava churns at the mouth of the active volcano.  The ring hisses, dark things, promises of power and greed, it would even implore and beg if it was capable of such a thing. This could be the end of your story, the end of your adventure, will there be ships to whisk you away once you throw the ring to the flames of Mount Doom?

>ask sam
You can't see any such thing.

>go to the shire
Shire
Round, colorful doors are set in the sprawling green hills, from the tops of which the smoke of small chimneys hints at homely meals shared at round tables. Some hobbits are venturing the paths between smials, others are enjoying the sun. Gandalf towers above all even while sitting on his favorite chair.

Sam & Pip are following you.

*** Run-time problem P25: Attempt to choose a blank row in a table with none left: table 'Table of Sam Responses'.

>ask sam about
 You could ask Sam & Pip about pipe-weed, Rivendell, Elf Council, the ring, pipe-weed, pipe-weed, Rivendell, Elf Council, the ring, pipe-weed, pipe-weed, Rivendell, Elf Council, the ring, pipe-weed, pipe-weed, Rivendell, Elf Council, the ring, pipe-weed, pipe-weed, Rivendell, Elf Council, the ring, pipe-weed, pipe-weed, Rivendell, Elf Council, the ring, pipe-weed, pipe-weed, Rivendell, Elf Council, the ring, pipe-weed, pipe-weed, Rivendell, Elf Council, the ring, pipe-weed, pipe-weed, Rivendell, Elf Council, the ring, pipe-weed, pipe-weed, Rivendell, Elf Council, the ring, pipe-weed, pipe-weed, Rivendell, Elf Council, the ring, pipe-weed, pipe-weed, Rivendell, Elf Council, the ring, pipe-weed, or pipe-weed.

>go inside
Bag End
You find yourself in a cavernicolous and airy room. Doors, windows and ceilings are round, like if someone has carved holes in the earth itself. Outside you can hear the laughter of children and the chirping of birds.

You can see a little table (on which are a green book and a map), a trunk (closed), a cupboard (closed), and a cushy armchair here.

Sam & Pip are following you.

*** Run-time problem P25: Attempt to choose a blank row in a table with none left: table 'Table of Sam Responses'.

>ask sam
 You could ask Sam & Pip about pipe-weed, Rivendell, Elf Council, the ring, pipe-weed, pipe-weed, Rivendell, Elf Council, the ring, pipe-weed, pipe-weed, Rivendell, Elf Council, the ring, pipe-weed, pipe-weed, Rivendell, Elf Council, the ring, pipe-weed, pipe-weed, Rivendell, Elf Council, the ring, pipe-weed, pipe-weed, Rivendell, Elf Council, the ring, pipe-weed, pipe-weed, Rivendell, Elf Council, the ring, pipe-weed, pipe-weed, Rivendell, Elf Council, the ring, pipe-weed, pipe-weed, Rivendell, Elf Council, the ring, pipe-weed, pipe-weed, Rivendell, Elf Council, the ring, pipe-weed, pipe-weed, Rivendell, Elf Council, the ring, pipe-weed, pipe-weed, Rivendell, Elf Council, the ring, pipe-weed, or pipe-weed.

>z
Time passes.

>go outside
Shire
Round, colorful doors are set in the sprawling green hills, from the tops of which the smoke of small chimneys hints at homely meals shared at round tables. Some hobbits are venturing the paths between smials, others are enjoying the sun. Gandalf towers above all even while sitting on his favorite chair.

Sam & Pip are following you.

*** Run-time problem P25: Attempt to choose a blank row in a table with none left: table 'Table of Sam Responses'.

>ask sam
 You could ask Sam & Pip about pipe-weed, Rivendell, Elf Council, the ring, pipe-weed, pipe-weed, Rivendell, Elf Council, the ring, pipe-weed, pipe-weed, Rivendell, Elf Council, the ring, pipe-weed, pipe-weed, Rivendell, Elf Council, the ring, pipe-weed, pipe-weed, Rivendell, Elf Council, the ring, pipe-weed, pipe-weed, Rivendell, Elf Council, the ring, pipe-weed, pipe-weed, Rivendell, Elf Council, the ring, pipe-weed, pipe-weed, Rivendell, Elf Council, the ring, pipe-weed, pipe-weed, Rivendell, Elf Council, the ring, pipe-weed, pipe-weed, Rivendell, Elf Council, the ring, pipe-weed, pipe-weed, Rivendell, Elf Council, the ring, pipe-weed, pipe-weed, Rivendell, Elf Council, the ring, pipe-weed, or pipe-weed.

>w
You can't go that way.

>e
Rivendell
At the edge of a narrow gorge, the peaceful elven town of Rivendell seems almost to sit on the river Bruinen. Wherever you are you can hear water streaming by or roaring down steep cliffs. Maybe before exploring you should look for someone to talk to.

You can see an Elf Lord and a pedestal (on which are an old sword and a mithril shirt) here.

Sam & Pip are following you.

*** Run-time problem P25: Attempt to choose a blank row in a table with none left: table 'Table of Sam Responses'.

>ask sam
 You could ask Sam & Pip about pipe-weed, Rivendell, Elf Council, the ring, pipe-weed, pipe-weed, Rivendell, Elf Council, the ring, pipe-weed, pipe-weed, Rivendell, Elf Council, the ring, pipe-weed, pipe-weed, Rivendell, Elf Council, the ring, pipe-weed, pipe-weed, Rivendell, Elf Council, the ring, pipe-weed, pipe-weed, Rivendell, Elf Council, the ring, pipe-weed, pipe-weed, Rivendell, Elf Council, the ring, pipe-weed, pipe-weed, Rivendell, Elf Council, the ring, pipe-weed, pipe-weed, Rivendell, Elf Council, the ring, pipe-weed, pipe-weed, Rivendell, Elf Council, the ring, pipe-weed, pipe-weed, Rivendell, Elf Council, the ring, pipe-weed, pipe-weed, Rivendell, Elf Council, the ring, pipe-weed, or pipe-weed.

>e
You can't go that way.

>w
Shire
Round, colorful doors are set in the sprawling green hills, from the tops of which the smoke of small chimneys hints at homely meals shared at round tables. Some hobbits are venturing the paths between smials, others are enjoying the sun. Gandalf towers above all even while sitting on his favorite chair.

Sam & Pip are following you.

*** Run-time problem P25: Attempt to choose a blank row in a table with none left: table 'Table of Sam Responses'.

>ask gandalf about me
"Sir, who I am?"... Did you smoke something? Are you alright? Is this some sort of test? You are Frodo Baggins, of course, hobbit of the Shire.

Now you could also ask Gandalf about him, the weather, or life.

>ask gandalf about wather
I d'ont see what you mean, sorry.

>ask gandalf about the wather
I d'ont see what you mean, sorry.

>ask gandalf about the weather
A lovely summery day, Frodo. The shadows of war are far but getting closer, soon even the Shire will know the end of its peace.

>ask gandalf about life
You shall not distract yourself with nonsensical and philosophical questions. If you are here to waste my time, go read a book.

Now you could also ask Gandalf about books, pipe-weed, or the quest.

>ask gandalf about the quest
A great adventure that will take you to places unknown. A long time ago the ring you now hold was created by Sauron, a great evil, to rule over Middle Earth. After a bloody war the ring was cut from its master's hand and lost to the ages. Somehow your uncle Bilbo found it and passed it on to you Frodo. You are the one, the chosen, he who must go to Mount Doom and destroy the ring once and for all. Before the world is plunged in darkness.

Now you could also ask Gandalf about the ring or Mount Doom.

>ask gandalf about Mount Doom
The great volcano lies south of here, beyond the mountains. It is the only place where the ring may be vanquished, the final destination to your adventure. I could accompany you there… may I suggest we use the Eagles? They are great beasts and should take us to Mount Doom in no time at all. Would you like to leave right now?

>y
An easy shortcut! How lucky you are!
 You mount on a beautiful Eagle and soon you find yourself flying above the green Shire. Is that really Sam down there, he looks so little, so small, maybe a little too miniscule. Are we sure we are safe flying so high? DON'T LOOK DOWN, DON'T…

It looks like you are too weak for this mode of transportation, we should stop before you throw up on yourself and the Eagle (she might eat you, they really like to keep themselves clean).
You are now in Rivendell...

Rivendell
At the edge of a narrow gorge, the peaceful elven town of Rivendell seems almost to sit on the river Bruinen. Wherever you are you can hear water streaming by or roaring down steep cliffs. Maybe before exploring you should look for someone to talk to.

You can see an Elf Lord and a pedestal (on which are an old sword and a mithril shirt) here.

Gandalf are following you.

>showme sam
Sam & Pip - character
location: in the Shire
singular-named, proper-named; unlit, inedible, portable; male, visible; following
list grouping key: none
printed name: "Sam & Pip"
printed plural name: "characters"
indefinite article: none
description: none
initial appearance: none
carrying capacity: 100
Responses Table: Table of Sam Responses
Seconde Responses Table: Table of Seconde Sam Responses
Answered List: them and the quest

>e
You can't go that way.

>w
Shire
Round, colorful doors are set in the sprawling green hills, from the tops of which the smoke of small chimneys hints at homely meals shared at round tables. Some hobbits are venturing the paths between smials, others are enjoying the sun. You can see Sam & Pip lounging on the grass.

Gandalf are following you.

*** Run-time problem P25: Attempt to choose a blank row in a table with none left: table 'Table of Gandalf Responses'.

>e
Rivendell
At the edge of a narrow gorge, the peaceful elven town of Rivendell seems almost to sit on the river Bruinen. Wherever you are you can hear water streaming by or roaring down steep cliffs. Maybe before exploring you should look for someone to talk to.

You can see an Elf Lord and a pedestal (on which are an old sword and a mithril shirt) here.

Gandalf are following you.

*** Run-time problem P25: Attempt to choose a blank row in a table with none left: table 'Table of Gandalf Responses'.

>showme sam
Sam & Pip - character
location: in the Shire
singular-named, proper-named; unlit, inedible, portable; male, visible; following
list grouping key: none
printed name: "Sam & Pip"
printed plural name: "characters"
indefinite article: none
description: none
initial appearance: none
carrying capacity: 100
Responses Table: Table of Sam Responses
Seconde Responses Table: Table of Seconde Sam Responses
Answered List: them and the quest

>w
Shire
Round, colorful doors are set in the sprawling green hills, from the tops of which the smoke of small chimneys hints at homely meals shared at round tables. Some hobbits are venturing the paths between smials, others are enjoying the sun. You can see Sam & Pip lounging on the grass.

Gandalf are following you.

*** Run-time problem P25: Attempt to choose a blank row in a table with none left: table 'Table of Gandalf Responses'.

>ask gandalf
 You could ask Gandalf about him, books, pipe-weed, the ring, me, Rivendell
, Mildred, the quest, him, books, pipe-weed, the ring, me, Rivendell
, Mildred, the quest, him, books, pipe-weed, the ring, me, Rivendell
, Mildred, the quest, him, books, pipe-weed, the ring, me, Rivendell
, Mildred, the quest, him, books, pipe-weed, the ring, me, Rivendell
, Mildred, the quest, him, books, pipe-weed, the ring, me, Rivendell
, Mildred, the quest, him, books, pipe-weed, the ring, me, Rivendell
, Mildred, the quest, him, books, pipe-weed, the ring, me, Rivendell
, Mildred, the quest, him, books, pipe-weed, the ring, me, Rivendell
, Mildred, the quest, him, books, pipe-weed, the ring, me, Rivendell
, Mildred, the quest, him, books, pipe-weed, the ring, me, Rivendell
, Mildred, the quest, him, books, pipe-weed, the ring, me, Rivendell
, Mildred, the quest, him, books, pipe-weed, the ring, me, Rivendell
, Mildred, the quest, him, books, pipe-weed, the ring, me, Rivendell
, or Rivendell
.

* * *

>i
You are carrying:
  a Ring

>put the ring
(in the Ring)
You can't put something inside itself.

>d
You can't go that way.

>y
That was a rhetorical question.

>talk to sam
To start a conversation, you need to use ASK Sam & Pip ABOUT something. Type "ask Sam & Pip (about)" to see the available topics.

>ask sam about
 You could ask Sam & Pip about them.

>ask sam about them
Frodo did you hit your head? I'm Sam, that's Pip, we have been friends for ages.

Now you could also ask Sam & Pip about pipe-weed or the quest.

>remove the ring
Do you really want to let go of all this power that is surging in you? You feel so good and so strong right now.

>i
Please answer yes or no.

>go inside
Please answer yes or no.

>put the map
Please answer yes or no.

>take the map
Please answer yes or no.

>remove the map
Please answer yes or no.

>wear the map
Please answer yes or no.

>i
Please answer yes or no.

>put on the ring
Please answer yes or no.

>i
Please answer yes or no.

>remove the ring
Please answer yes or no.

>drop ring
Please answer yes or no.

>put on the ring
Please answer yes or no.

>y
You slowly remove the ring from your finger, wary of the bad feeling.
This feels weird, you feel weird…your vision isn't the same, what happened?! You lift your hand in front of your eyes but…you can see through it! Are you invisible?!

You aren't wearing the Ring.

>put the ring
(in the Ring)
You can't put something inside itself.

>put the map in the ring
You can't see any such thing.

>go outside
You can't go that way.

>ask gandalf about him
I d'ont see what you mean, sorry.

>go inside
Bag End
You find yourself in a cavernicolous and airy room. Doors, windows and ceilings are round, like if someone has carved holes in the earth itself. Outside you can hear the laughter of children and the chirping of birds.

You can see a little table (on which are a green book and a map), a trunk (closed), a cupboard (closed), and a cushy armchair here.

>put on the book
You take the green book but...

You can't wear that!

>w
You can't go that way.

* * *

>e
You can't go that way.

>go outside
Shire
Round, colorful doors are set in the sprawling green hills, from the tops of which the smoke of small chimneys hints at homely meals shared at round tables. Some hobbits are venturing the paths between smials, others are enjoying the sun. Gandalf towers above all even while sitting on his favorite chair. You can see Sam & Pip lounging on the grass.

>e
Rivendell
At the edge of a narrow gorge, the peaceful elven town of Rivendell seems almost to sit on the river Bruinen. Wherever you are you can hear water streaming by or roaring down steep cliffs. Maybe before exploring you should look for someone to talk to.

You can see an Elf Lord and a pedestal (on which are an old sword and a mithril shirt) here.

>put on the shirt
You take the mithril shirt but...

... you not sure about the utility of wearing it.

>take off the shirt
You take off the mithril shirt.

>i
You are carrying:
  a mithril shirt
  a green book
  a Ring

A tall lady elf, her hands crossed behind her back, approaches you slowly. Her long dress swishes on the marble pavements. "I am Lady Amarië, messenger to Elf Council. Your plea for help in your quest has been discussed at long in the sacred halls of the council, the task of the destruction of the ring is one of great importance to all of Middle-Earth. That said, you are an incredibly weak hobbit Frodo Baggins and we do not think that you will be able to make it to Mount Doom and destroy the ring before Sauron finds you. You are unworthy, we will not help. In a few hundred years, maybe, a brave hobbit will be born to your line, one who will withstand the journey and its perils. In the meantime I advise you to go back to the Shire and enjoy a quiet and peaceful life." She turns around and slowly walks away. You would say something but you're pretty sure your jaw has hit the floor at some point.

>put on the shirt
... you not sure about the utility of wearing it.

>i
You are carrying:
  a mithril shirt (being worn)
  a green book
  a Ring

>take off the shirt
You take off the mithril shirt.

>take off the ring
Do you really want to let go of all this power that is surging in you? You feel so good and so strong right now.

>y
You slowly remove the ring from your finger, wary of the bad feeling.
This feels weird, you feel weird…your vision isn't the same, what happened?! You lift your hand in front of your eyes but…you can see through it! Are you invisible?!

You aren't wearing the Ring.

>i
You are carrying:
  a mithril shirt
  a green book
  a Ring

>put on the ring
You have a bad feeling about this ring. Are you really sure you want to do that?

>y
You slowly put the ring on your finger, wary of the bad feeling.
This feels weird, you feel weird…your vision isn't the same, what happened?! You lift your hand in front of your eyes but…you can see through it! Are you invisible?!

You're already wearing that!

>r
That's not a verb I recognize.

>i
You are carrying:
  a mithril shirt
  a green book
  a Ring (being worn)

>take off the ring
Do you really want to let go of all this power that is surging in you? You feel so good and so strong right now.

>n
Yeah, it's better this way.

>take off ring
Do you really want to let go of all this power that is surging in you? You feel so good and so strong right now.

>y
You slowly remove the ring from your finger, wary of the bad feeling.
This feels weird, you feel weird…your vision isn't the same, what happened?! You lift your hand in front of your eyes but…you can see through it! Are you invisible?!

You take off the Ring.

>put on ring
You have a bad feeling about this ring. Are you really sure you want to do that?

>n
Yeah, it's better this way.

* * *

>go outside
Shire
Round, colorful doors are set in the sprawling green hills, from the tops of which the smoke of small chimneys hints at homely meals shared at round tables. Some hobbits are venturing the paths between smials, others are enjoying the sun. Gandalf towers above all even while sitting on his favorite chair. You can see Sam & Pip lounging on the grass.

>put on the ring
You have a bad feeling about this ring. Are you really sure you want to do that?

* * *

>y
You slowly put the ring on your finger, wary of the bad feeling.

This feels weird, you feel weird…your vision isn't the same, what happened?! You lift your hand in front of your eyes but…you can see through it! Are you invisible?!

>ask gandalf about him
You ask Gandalf about him but he doesn't seem to see or hear you.

>remove the ring
Do you really want to let go of all this power that is surging in you? You feel so good and so strong right now.

>y
After removing the ring, you feel like you've escaped great danger.

>ask gandalf about him
I d'ont see what you mean, sorry.

>ask gandalf about
 You could ask Gandalf about you.

>ask gandalf about you
I d'ont see what you mean, sorry.

>ask gandalf about me
"Sir, who I am?"... Did you smoke something? Are you alright? Is this some sort of test? You are Frodo Baggins, of course, hobbit of the Shire.

Now you could also ask Gandalf about him, the weather, or life.

>ask gandalf about
 You could ask Gandalf about him, the weather, or life.

>put on the ring
You have a bad feeling about this ring. Are you really sure you want to do that?

* * *

>y
You slowly put the ring on your finger, wary of the bad feeling.

This feels weird, you feel weird…your vision isn't the same, what happened?! You lift your hand in front of your eyes but…you can see through it! Are you invisible?!

>ask gandalf
 You could ask Gandalf about him, the weather, or life.

>talk to gandalf
To start a conversation, you need to use ASK Gandalf ABOUT something. Type "ask Gandalf (about)" to see the available topics.

>ask gandalf about him
You ask Gandalf about him but he doesn't seem to see or hear you.

>ask gandalf about life
You ask Gandalf about life but he doesn't seem to see or hear you.

>ask gandalf about the weather
You ask Gandalf about the weather but he doesn't seem to see or hear you.

>ask gandalf about the universe
You ask Gandalf about the universe but he doesn't seem to see or hear you.

>ask gandalf about trolololo
You ask Gandalf about trolololo but he doesn't seem to see or hear you.

>go to mount doom
Mount Doom
The heat is blistering, suffocating. Somewhere belove you licks of flame run along barren rock and molten lava churns at the mouth of the active volcano.  The ring hisses, dark things, promises of power and greed, it would even implore and beg if it was capable of such a thing. This could be the end of your story, the end of your adventure, will there be ships to whisk you away once you throw the ring to the flames of Mount Doom?

>trhow the ring into mount doom
That's not a verb I recognize.

>throw the ring into mount doom
The ring fights you; it thrashes in your fingers, it implores, in its whispered hisses, but you manage to throw it into the lava. You see it slowly melt away in the fires of the volcano. A great weight seems to have lifted from your shoulders.

    *** Despite the blistering and suffocating heat a great wind suddenly picks up. You know this feeling of being pulled in different directions, your hair flipping wildly about. 

WOOOOOSH

You find yourself in the old room, the beautiful paintings are still there, as is the book, now closed and resting, unassuming, on the table. One thing is different, though, one thing has changed. There is a door now, a simple wooden door that you open with almost giddy satisfaction. As soon as you are outside you breathe a sigh of relief.
Isn't this library just beautiful? You came in here looking for your favorite book and you somehow got lost in between the racks. There was a…door? You turn around but all you see is a blank wall and nothing more. Mmh…something at the back of your mind whispers of a great adventure…something, with a book...and smoking? You really cannot remember now. Well, it must not be that important. It's time to get something to eat anyway. You leave, never looking back, but feeling somewhat satisfied with yourself. ***

Would you like to RESTART, RESTORE a saved game, QUIT, or UNDO the last command?

* * *

>open the cup
You open the cupboard, revealing a loaf of bread, an apple, and a peach.

>take book
Taken.

>take bread
Taken.

>drop loaf
Dropped.

>i
You are carrying:
  a green book
  The Ring

>look around
You can't see any such thing.

>look
Bag End
You find yourself in a cavernicolous and airy room. Doors, windows and ceilings are round, like if someone has carved holes in the earth itself. Outside you can hear the laughter of children and the chirping of birds.

You can see a loaf of bread, a little table (on which is a map), a trunk (closed), a cupboard (in which are an apple and a peach), and a cushy armchair here.

>open trunk
You open the trunk, revealing a pipe and a bag of money.

>break trunk
Violence isn't the answer to this one.

>take money
Taken.

>take the pipe
Taken.

>go outside
Shire
Round, colorful doors are set in the sprawling green hills, from the tops of which the smoke of small chimneys hints at homely meals shared at round tables. Some hobbits are venturing the paths between smials, others are enjoying the sun. Gandalf towers above all even while sitting on his favorite chair. You can see Sam & Pip lounging on the grass.

>ask pip about
 You could ask Sam & Pip about them.

>ask sam about him
Frodo did you hit your head? I'm Sam, that's Pip, we have been friends for ages.

Now you could also ask about pipe-weed or the quest.

>ask sam about pipe
"Well…we stole, I mean borrowed! We borrowed some from old Dinodas while he was drunk. Would you like some?"
Sam & Pip give you some nice pipe-weed.

>ask sam about quest
"Oh, you mean the ring? The one that you should destroy? That is some serious business Pip, don't you think?"
 "Very serious, Sam…"
. "Well, I guess as your friends we should accompany and make sure you don't get eaten by an orc."
 "We are such good friends…where should we start Sam?"
 "Maybe with the Elves? I think Rivendell lies east of here, should we go there Frodo? I think they could help."

>d
Please answer yes or no.

>y
The road is long, but Sam & Pip are good company. You share every meal, sing the songs of the Shire when you feel too tired to think and, in the end, you make your way to the elf's city of Rivendell, where the Elf Council is deliberating on if and how much to help you in your quest.

* * *

>out
Shire
Round, colorful doors are set in the sprawling green hills, from the tops of which the smoke of small chimneys hints at homely meals shared at round tables. Some hobbits are venturing the paths between smials, others are enjoying the sun. Gandalf towers above all even while sitting on his favorite chair. You can see Sam & Pip lounging on the grass.

>ask gandalf about
 You could ask Gandalf about you.

>ask gandalf about me
"Sir, who I am?"... Did you smoke something? Are you alright? Is this some sort of test? You are Frodo Baggins, of course, hobbit of the Shire.

Now you could also ask about him, the weather, or life.

>ask gandalf about
 You could ask Gandalf about him, the weather, or life.

>ask gandalf about him
I am Gandalf the Grey. I was sent to Middle Earth to help destroy the ring that you now hold. I am an Istar, a wizard of old.

>ask gandalf about
 You could ask Gandalf about the weather or life.

>ask gandalf about life
You shall not distract yourself with nonsensical and philosophical questions. If you are here to waste my time, go read a book.

Now you could also ask about books, pipe-weed, or the quest.

>ask gandalf about
 You could ask Gandalf about the weather, books, pipe-weed, or the quest.

>ask gandalf about climate
A lovely summery day, Frodo. The shadows of war are far but getting closer, soon even the Shire will know the end of its peace.

* * *

>out
Shire
Round, colorful doors are set in the sprawling green hills, from the tops of which the smoke of small chimneys hints at homely meals shared at round tables. Some hobbits are venturing the paths between smials, others are enjoying the sun. Gandalf towers above all even while sitting on his favorite chair. You can see Sam & Pip lounging on the grass.

>ask gandalf about me
"Sir, who I am?"... Did you smoke something? Are you alright? Is this some sort of test? You are Frodo Baggins, of course, hobbit of the Shire.

Now you could also ask about him, the weather, or life.

>ask gandaf about the cool
You can't see any such thing.

>ask gandaf about the univers
You can't see any such thing.

>ask gandaf about the universe
You can't see any such thing.

>ask gandalf about what are you
I am Gandalf the Grey. I was sent to Middle Earth to help destroy the ring that you now hold. I am an Istar, a wizard of old.

>ask gandalf about caca
I d'ont see what you mean, sorry.

>ask gandalf about caca universe
I d'ont see what you mean, sorry.

>ask gandalf about the universe
You shall not distract yourself with nonsensical and philosophical questions. If you are here to waste my time, go read a book.

Now you could also ask about books, pipe-weed, or the quest.

* * *

>ask gandalf about me
"Sir, who I am?"... Did you smoke something? Are you alright? Is this some sort of test? You are Frodo Baggins, of course, hobbit of the Shire.

Now you could also ask about him, the weather, or life.

>ask gandalf about cilmate
I d'ont see what you mean, sorry.

>ask gandalf about the cilmate
I d'ont see what you mean, sorry.

>ask gandalf about the weather
A lovely summery day, Frodo. The shadows of war are far but getting closer, soon even the Shire will know the end of its peace.

>ask gandalf about who are you
I am Gandalf the Grey. I was sent to Middle Earth to help destroy the ring that you now hold. I am an Istar, a wizard of old.

>ask gandalf about the life
You shall not distract yourself with nonsensical and philosophical questions. If you are here to waste my time, go read a book.

Now you could also ask about books, pipe-weed, or the quest.

* * *

>out
Shire
Round, colorful doors are set in the sprawling green hills, from the tops of which the smoke of small chimneys hints at homely meals shared at round tables. Some hobbits are venturing the paths between smials, others are enjoying the sun. Gandalf towers above all even while sitting on his favorite chair. You can see Sam & Pip lounging on the grass.

>ask sam about them
Frodo did you hit your head? I'm Sam, that's Pip, we have been friends for ages.

Now you could also ask about pipe-weed or the quest.

* * *

>e
Rivendell
At the edge of a narrow gorge, the peaceful elven town of Rivendell seems almost to sit on the river Bruinen. Wherever you are you can hear water streaming by or roaring down steep cliffs. Maybe before exploring you should look for someone to talk to.

You can see an Elf Lord and a pedestal (on which are an old sword and a mithril shirt) here.

The Elf Council is in session now. You should hear from them soon.

Sam & Pip followed you.

>ask sam about
 You could ask Sam & Pip about pipe-weed, Rivendell, the Elf Council, the ring, or pipe-weed.

>ask sam about council
Last we heard they were still deliberating, but I bet that they will soon be out.

* * *

>e
This is the way for Rivendell, but history doesn't want you to go into the woods alone, sorry.

>w
lol

>w
lol

>e
This is the way for Rivendell, but history doesn't want you to go into the woods alone, sorry.

* * *

>w
lol

>d
lol

>u
lol

* * *

>outside
Shire
Round, colorful doors are set in the sprawling green hills, from the tops of which the smoke of small chimneys hints at homely meals shared at round tables. Some hobbits are venturing the paths between smials, others are enjoying the sun. Gandalf towers above all even while sitting on his favorite chair. You can see Sam & Pip lounging on the grass.

>ask gandlaf about him
You can't see any such thing.

>ask gandalf about him
I d'ont see what you mean, sorry.

>ask gandalf about me
"Sir, who I am?"... Did you smoke something? Are you alright? Is this some sort of test? You are Frodo Baggins, of course, hobbit of the Shire.

Now you could also ask about him, the weather, or life.

>ask about the climate
You can't see any such thing.

>ask about the weather
You can't see any such thing.

>ask gandalf about the weather
I d'ont see what you mean, sorry.

>ask gandalf about the climate
I d'ont see what you mean, sorry.

* * *

>put on the ring
You have a bad feeling about this ring. Are you really sure you want to do that?

* * *

>y
You slowly put the ring on your finger, wary of the bad feeling.

This feels weird, you feel weird…your vision isn't the same, what happened?! You lift your hand in front of your eyes but…you can see through it! Are you invisible?!

>z
Time passes.

>remove the ring
Do you really want to let go of all this power that is surging in you? You feel so good and so strong right now.

* * *

>y
After removing the ring, you feel like you've escaped great danger.

>showme ring
Ring - thing
location: carried by yourself in the Bag End
singular-named, improper-named; unlit, inedible, portable, wearable, handled
list grouping key: none
printed name: "Ring"
printed plural name: none
indefinite article: none
description: none
initial appearance: "A simple band of gold, when heated it reveals a script in Elvish runes. You can feel a dark power emanating from it."
usage limit: 7

>z
Time passes.

>showme ring
Ring - thing
location: carried by yourself in the Bag End
singular-named, improper-named; unlit, inedible, portable, wearable, handled
list grouping key: none
printed name: "Ring"
printed plural name: none
indefinite article: none
description: none
initial appearance: "A simple band of gold, when heated it reveals a script in Elvish runes. You can feel a dark power emanating from it."
usage limit: 8

>put on the ring
You have a bad feeling about this ring. Are you really sure you want to do that?

* * *

>y
You slowly put the ring on your finger, wary of the bad feeling.

This feels weird, you feel weird…your vision isn't the same, what happened?! You lift your hand in front of your eyes but…you can see through it! Are you invisible?!

>show me the ring
You see nothing special about the Ring.

You feel the Great Eye following you.

>showme the ring
Ring - thing
location: worn by yourself in the Bag End
singular-named, improper-named; unlit, inedible, portable, wearable, handled
list grouping key: none
printed name: "Ring"
printed plural name: none
indefinite article: none
description: none
initial appearance: "A simple band of gold, when heated it reveals a script in Elvish runes. You can feel a dark power emanating from it."
usage limit: 4

>showme the ring
Ring - thing
location: worn by yourself in the Bag End
singular-named, improper-named; unlit, inedible, portable, wearable, handled
list grouping key: none
printed name: "Ring"
printed plural name: none
indefinite article: none
description: none
initial appearance: "A simple band of gold, when heated it reveals a script in Elvish runes. You can feel a dark power emanating from it."
usage limit: 4

>z
Time passes.

You feel the Great Eye following you.

>showme the ring
Ring - thing
location: worn by yourself in the Bag End
singular-named, improper-named; unlit, inedible, portable, wearable, handled
list grouping key: none
printed name: "Ring"
printed plural name: none
indefinite article: none
description: none
initial appearance: "A simple band of gold, when heated it reveals a script in Elvish runes. You can feel a dark power emanating from it."
usage limit: 2

>remove the ring
Do you really want to let go of all this power that is surging in you? You feel so good and so strong right now.

* * *

>y
After removing the ring, you feel like you've escaped great danger.

>showme the ring
Ring - thing
location: carried by yourself in the Bag End
singular-named, improper-named; unlit, inedible, portable, wearable, handled
list grouping key: none
printed name: "Ring"
printed plural name: none
indefinite article: none
description: none
initial appearance: "A simple band of gold, when heated it reveals a script in Elvish runes. You can feel a dark power emanating from it."
usage limit: 3

>showme the ring
Ring - thing
location: carried by yourself in the Bag End
singular-named, improper-named; unlit, inedible, portable, wearable, handled
list grouping key: none
printed name: "Ring"
printed plural name: none
indefinite article: none
description: none
initial appearance: "A simple band of gold, when heated it reveals a script in Elvish runes. You can feel a dark power emanating from it."
usage limit: 3

>z
Time passes.

>showme the ring
Ring - thing
location: carried by yourself in the Bag End
singular-named, improper-named; unlit, inedible, portable, wearable, handled
list grouping key: none
printed name: "Ring"
printed plural name: none
indefinite article: none
description: none
initial appearance: "A simple band of gold, when heated it reveals a script in Elvish runes. You can feel a dark power emanating from it."
usage limit: 7

>z
Time passes.

>showme the ring
Ring - thing
location: carried by yourself in the Bag End
singular-named, improper-named; unlit, inedible, portable, wearable, handled
list grouping key: none
printed name: "Ring"
printed plural name: none
indefinite article: none
description: none
initial appearance: "A simple band of gold, when heated it reveals a script in Elvish runes. You can feel a dark power emanating from it."
usage limit: 10

>z
Time passes.

* * *

>showme the ring
Ring - thing
location: carried by yourself in the Bag End
singular-named, improper-named; unlit, inedible, portable, wearable, handled
list grouping key: none
printed name: "Ring"
printed plural name: none
indefinite article: none
description: none
initial appearance: "A simple band of gold, when heated it reveals a script in Elvish runes. You can feel a dark power emanating from it."
usage limit: 10

>put on the ring
You have a bad feeling about this ring. Are you really sure you want to do that?

* * *

>z
Time passes.

>z
Time passes.

You feel the Great Eye following you.

>z
Time passes.

You feel the Great Eye following you.

>showme ring
Ring - thing
location: worn by yourself in the Bag End
singular-named, improper-named; unlit, inedible, portable, wearable, handled
list grouping key: none
printed name: "Ring"
printed plural name: none
indefinite article: none
description: none
initial appearance: "A simple band of gold, when heated it reveals a script in Elvish runes. You can feel a dark power emanating from it."
usage limit: 2

>remove the ring
Do you really want to let go of all this power that is surging in you? You feel so good and so strong right now.

* * *

>y
After removing the ring, you feel like you've escaped great danger.

>showme ring
Ring - thing
location: carried by yourself in the Bag End
singular-named, improper-named; unlit, inedible, portable, wearable, handled
list grouping key: none
printed name: "Ring"
printed plural name: none
indefinite article: none
description: none
initial appearance: "A simple band of gold, when heated it reveals a script in Elvish runes. You can feel a dark power emanating from it."
usage limit: 3

>put on the ring
You have a bad feeling about this ring. Are you really sure you want to do that?

>y
You slowly put the ring on your finger, wary of the bad feeling.

This feels weird, you feel weird…your vision isn't the same, what happened?! You lift your hand in front of your eyes but…you can see through it! Are you invisible?!

You feel the Great Eye following you.

>showme ring
Ring - thing
location: worn by yourself in the Bag End
singular-named, improper-named; unlit, inedible, portable, wearable, handled
list grouping key: none
printed name: "Ring"
printed plural name: none
indefinite article: none
description: none
initial appearance: "A simple band of gold, when heated it reveals a script in Elvish runes. You can feel a dark power emanating from it."
usage limit: 1

>z
Time passes.

You see a nazgul on the back of a dragon rushing towards you. No time to escape, he picks you up in his claw.
You who wanted to go to modror, I think it's successful. But yeah, it was not to give the ring to Sauron, you knew it yet, didn't you?

    *** Game Over ***

Would you like to RESTART, RESTORE a saved game, QUIT, or UNDO the last command?

* * *

>sit on chair
You get onto the cushy armchair.

>sit off the chair
I didn't understand that sentence.

>sit off chair
I didn't understand that sentence.

>go out the chair
I only understood you as far as wanting to go outside.

* * *

>take map
Taken.

>take table
That's fixed in place.

>take book
Taken.

>go to mount doom
Mount Doom
The heat is blistering, suffocating. Somewhere belove you licks of flame run along barren rock and molten lava churns at the mouth of the active volcano.  The ring hisses, dark things, promises of power and greed, it would even implore and beg if it was capable of such a thing.  
 This could be the end of your story, the end of your adventure, will there be ships to whisk you away once you throw the ring to the flames of Mount Doom?

You can see a volcano (empty) here.

>throw the map into the lava
You throw the map into the lava... you see it burning.

>throw the book into volcano
You throw the green book into the lava... you see it burning.

* * *

Lord of the Read
An Interactive Fiction by Simon, Tessa and Marcela
Release 1 / Serial number 210604 / Inform 7 build 6M62 (I6/v6.34 lib 6/12N) SD

Old room
Something here calls to you, like a whisper in the wind or the faint rustling of the worn pages of a well-loved book. Around and above you the walls are covered in paint. You can't seem to remember how you made it here. There are no doors, no way for you to get out, not even a window to suggest where in the world you are.

You can see an old table (on which is a mysterious book) here.

>read the book
Holding your breath, you carefully open the book.

"...One Ring to rule them all, One Ring to find them,
One Ring to bring them all and in the darkness bind them.
In the Land of Mordor where the Shadows lie..."

You can barely make out a few sentences before words and letters begin to move in concentric swirls. You try to take a step back, but your fingers are stuck to the pages.
WOOOOOSH
 A great wind pulls at you and the only thing you can do is scream and scream in terror. You look one last time at the beautiful paintings on the walls and then everything goes black.

Bag End
You find yourself in a cavernicolous and airy room. Doors, windows and ceilings are round, like if someone has carved holes in the earth itself. Outside you can hear the laughter of children and the chirping of birds.

You can see a little table (on which are a green book and a map), a trunk (closed), a cupboard (closed), and a cushy armchair here.

>read the book
You open the green book at a random page.

This is the story of the fellow from out of time and space 

There was, once upon a time,
a young lost fellow without dime.
Taken by a book, he said
but the hobbits just thought him mad.
He looked around, and he went east,
then west, then back, then flew on a great beast.
For the life of him he could not remember,
how he came to be or if it was July or December.
He spoke with many, fought with few, 
but in the end, he decided to just enjoy the view.
He rolled his weed, sat on a chair,
took out his pipe and smoked without flair.

Here ends the story of the young fellow,
he sure must have been relaxed and mellow,
because soon he disappeared 
leaving behind not even a hair of beard,
without a first breakfast, a second or a third;
whispers say that he returned to his place of birth. 
But alas, no hobbit ever saw the fellow again,
and so, with the best weed and the pipe most plain,
they sometimes meet, under the summery sun,
to enjoy a good smoke and pun,
in honor of the fellow,
who decided to stay mellow,
despite being lost, and alone,
adventurous and a bit injury prone. 

The one that smoked and then was just gone.

You earmark the page and close the book, baffled.

>book
That's not a verb I recognize.

>show me book
(first taking the green book)
As green as fine summery grass, the title of the book stands boldly on its front "Surviving Your First High and Other Ways to Have the Best Time of Your Life With Weed".

>go outside
Shire
Round, colorful doors are set in the sprawling green hills, from the tops of which the smoke of small chimneys hints at homely meals shared at round tables. Some hobbits are venturing the paths between smials, others are enjoying the sun. Gandalf towers above all even while sitting on his favorite chair. You can see Sam & Pip lounging on the grass.

>w
You can't go that way.

* * *

>e
This is the way for Rivendell, but history doesn't want you to go into the woods alone, sorry.

>showme me
yourself - person
    green book - book
    Ring
location: in the Shire
singular-named, proper-named; unlit, inedible, portable; male, visible
list grouping key: none
printed name: "yourself"
printed plural name: "people"
indefinite article: none
description: "As good-looking as ever."
initial appearance: none
carrying capacity: 100